Step,mass_grown,mass_burnt,trees_grown,trees_burnt,trees_count,trees_mass,ashes_count,ashes_mass,empty_count
100,28244,26956,6194,5878,22366,86902,67627,0,7
101,28485,27370,6119,5843,22642,88017,67351,0,7
102,28711,28591,6069,6074,22637,88137,67358,0,5
103,28750,28508,6113,6152,22598,88379,67397,0,5
104,28692,28870,6094,6182,22510,88201,67486,0,4
105,28660,28574,6150,6126,22534,88287,67463,0,3
106,28697,28433,6163,6026,22671,88551,67326,0,3
107,28816,28665,6145,6207,22609,88702,67388,0,3
108,28770,28139,6161,5977,22793,89333,67204,0,3
109,28851,29952,6058,6320,22531,88232,67466,0,3
110,28646,30473,6115,6352,22294,86405,67704,0,2
111,28342,26949,6048,5761,22581,87798,67417,0,2
112,28717,27092,6136,5837,22880,89423,67118,0,2
113,28970,30546,6090,6416,22554,87847,67444,0,2
114,28552,27052,5998,5761,22791,89347,67207,0,2
115,28824,28682,6033,6083,22741,89489,67257,0,2
116,28838,29309,6097,6289,22549,89018,67449,0,2
117,28645,30135,6096,6360,22285,87528,67713,0,2
118,28481,27285,6196,5785,22696,88724,67302,0,2
119,28815,28110,6119,5985,22830,89429,67169,0,1
120,29042,29359,6212,6234,22808,89112,67191,0,1
121,28762,29309,5954,6174,22588,88565,67411,0,1
122,28783,29063,6195,6272,22511,88285,67488,0,1
123,28584,28116,6073,5935,22649,88753,67350,0,1
124,28657,28540,6008,6059,22598,88870,67401,0,1
125,28846,29991,6248,6357,22489,87725,67510,0,1
126,28440,30575,5951,6458,21982,85590,68017,0,1
127,28055,25202,6073,5405,22650,88443,67349,0,1
128,28641,27864,5991,5965,22676,89220,67324,0,0
129,28812,28160,6136,5922,22890,89872,67110,0,0
130,29021,29295,6131,6185,22836,89598,67164,0,0
131,29023,27148,6187,5841,23182,91473,66818,0,0
132,29379,32395,6197,6792,22587,88457,67413,0,0
133,28663,28388,6076,6037,22626,88732,67374,0,0
134,28820,29269,6194,6281,22539,88283,67461,0,0
135,28794,29141,6255,6248,22546,87936,67454,0,0
136,28759,29341,6213,6271,22488,87354,67512,0,0
137,28574,28421,6086,5958,22616,87507,67384,0,0
138,28689,28585,6073,6090,22599,87611,67401,0,0
139,28640,30077,6041,6365,22275,86174,67725,0,0
140,28284,27020,6009,5778,22506,87438,67494,0,0
141,28613,27223,6107,5934,22679,88828,67321,0,0
142,28914,27867,6235,5945,22969,89875,67031,0,0
143,29123,31167,6154,6559,22564,87831,67436,0,0
144,28684,28267,6120,5978,22706,88248,67294,0,0
145,28792,27250,6086,5893,22899,89790,67101,0,0
146,29023,30932,6124,6606,22417,87881,67583,0,0
147,28623,28925,6206,6125,22498,87579,67502,0,0
148,28533,27135,6035,5774,22759,88977,67241,0,0
149,28894,27664,6135,5961,22933,90207,67067,0,0
150,29085,31572,6152,6641,22444,87720,67556,0,0
151,28618,27639,6174,5887,22731,88699,67269,0,0
152,28941,29661,6210,6316,22625,87979,67375,0,0
153,28840,28735,6215,6170,22670,88084,67330,0,0
154,28696,28372,6026,5943,22753,88408,67247,0,0
155,28825,28221,6072,6073,22752,89012,67248,0,0
156,28806,28266,6054,6094,22712,89552,67288,0,0
157,28741,29760,6029,6359,22382,88533,67618,0,0
158,28542,29896,6160,6298,22244,87179,67756,0,0
159,28422,29221,6178,6203,22219,86380,67781,0,0
160,28316,26518,6097,5699,22617,88178,67383,0,0
161,28718,27479,6101,5962,22756,89417,67244,0,0
162,28817,27193,6061,5714,23103,91041,66897,0,0
163,29145,30153,6042,6374,22771,90033,67229,0,0
164,28948,27455,6177,5798,23150,91526,66850,0,0
165,29287,29644,6137,6246,23041,91169,66959,0,0
166,29176,30563,6135,6458,22718,89782,67282,0,0
167,28898,31817,6180,6647,22251,86863,67749,0,0
168,28333,28092,6082,5968,22365,87104,67635,0,0
169,28453,28900,6088,6076,22377,86657,67623,0,0
170,28590,27221,6213,5825,22765,88026,67235,0,0
171,28960,27072,6195,5827,23133,89914,66867,0,0
172,29235,28227,6102,6125,23110,90922,66890,0,0
173,29273,32140,6163,6855,22418,88055,67582,0,0
174,28603,27544,6185,5865,22738,89114,67262,0,0
175,28970,27288,6232,5913,23057,90796,66943,0,0
176,29125,29269,6068,6140,22985,90652,67015,0,0
177,29055,30419,6070,6356,22699,89288,67301,0,0
178,28791,29291,6092,6164,22627,88788,67373,0,0
179,28804,28615,6177,6060,22744,88977,67256,0,0
180,28790,27558,6046,5926,22864,90209,67136,0,0
181,29074,29874,6210,6331,22743,89409,67257,0,0
182,28903,30211,6160,6491,22412,88101,67588,0,0
183,28728,29264,6316,6230,22498,87565,67502,0,0
184,28611,27216,6113,5777,22834,88960,67166,0,0
185,28989,30208,6155,6432,22557,87741,67443,0,0
186,28734,26099,6177,5646,23088,90376,66912,0,0
187,29299,31464,6211,6661,22638,88211,67362,0,0
188,28701,29877,6063,6292,22409,87035,67591,0,0
189,28560,25336,6151,5506,23054,90259,66946,0,0
190,29181,29517,6127,6235,22946,89923,67054,0,0
191,29036,29785,6090,6316,22720,89174,67280,0,0
192,28781,28738,6061,6125,22656,89217,67344,0,0
193,28737,30761,6081,6381,22356,87193,67644,0,0
194,28449,29676,6093,6285,22164,85966,67836,0,0
195,28394,27197,6230,5858,22536,87163,67464,0,0
196,28712,30219,6176,6479,22233,85656,67767,0,0
197,28281,27405,6048,5926,22355,86532,67645,0,0
198,28557,28343,6202,6110,22447,86746,67553,0,0
199,28653,26810,6206,5742,22911,88589,67089,0,0
200,29047,26862,6136,5900,23147,90774,66853,0,0
201,29220,29658,6073,6259,22961,90336,67039,0,0
202,29135,31301,6174,6605,22530,88170,67470,0,0
203,28750,28794,6220,6157,22593,88126,67407,0,0
204,28637,30736,6044,6473,22164,86027,67836,0,0
205,28211,28250,6047,6064,22147,85988,67853,0,0
206,28268,27573,6121,5845,22423,86683,67577,0,0
207,28514,25976,6091,5598,22916,89221,67084,0,0
208,29240,28652,6324,6155,23085,89809,66915,0,0
209,29201,30393,6116,6476,22725,88617,67275,0,0
210,28833,30092,6108,6404,22429,87358,67571,0,0
211,28545,25407,6116,5457,23088,90496,66912,0,0
212,29069,30792,5981,6476,22593,88773,67407,0,0
213,28951,31424,6358,6671,22280,86300,67720,0,0
214,28360,29569,6080,6233,22127,85091,67873,0,0
215,28162,25275,6035,5471,22691,87978,67309,0,0
216,28719,28786,6028,6109,22610,87911,67390,0,0
217,28580,27133,5970,5839,22741,89358,67259,0,0
218,28954,28553,6213,6084,22870,89759,67130,0,0
219,28968,27661,6098,5868,23100,91066,66900,0,0
220,29289,29934,6189,6427,22862,90421,67138,0,0
221,29046,27676,6184,5910,23136,91791,66864,0,0
222,29381,32190,6245,6715,22666,88982,67334,0,0
223,28889,30749,6223,6607,22282,87122,67718,0,0
224,28398,28634,6116,6072,22326,86886,67674,0,0
225,28532,28252,6206,6015,22517,87166,67483,0,0
226,28647,27853,6130,5985,22662,87960,67338,0,0
227,28740,27016,6078,5748,22992,89684,67008,0,0
228,29121,29742,6129,6319,22802,89063,67198,0,0
229,29037,30865,6235,6548,22489,87235,67511,0,0
230,28472,28482,5983,6036,22436,87225,67564,0,0
231,28508,27346,6072,5907,22601,88387,67399,0,0
232,28747,31063,6146,6635,22112,86071,67888,0,0
233,28244,27158,6132,5837,22407,87157,67593,0,0
234,28429,26701,6022,5752,22677,88885,67323,0,0
235,28931,28508,6254,6168,22763,89308,67237,0,0
236,28848,9268,6085,1984,26864,108888,63136,0,0
237,32627,14381,5763,2839,29788,127134,60212,0,0
238,35418,21881,5630,4215,31203,140671,58797,0,0
239,36842,36757,5639,6625,30217,140756,59783,0,0
240,35913,40607,5696,7074,28839,136062,61161,0,0
241,34636,38797,5797,6704,27932,131901,62068,0,0
242,33835,39180,5903,6657,27178,126556,62822,0,0
243,32931,42356,5753,6986,25945,117131,64055,0,0
244,31902,35383,5957,5821,26081,113650,63919,0,0
245,31919,30353,5838,5164,26755,115216,63245,0,0
246,32672,28642,5917,4888,27784,119246,62216,0,0
247,33627,33732,5843,5743,27884,119141,62116,0,0
248,33662,28554,5778,4993,28669,124249,61331,0,0
249,34496,38302,5827,6765,27731,120443,62269,0,0
250,33426,36116,5695,6357,27069,117753,62931,0,0
251,33060,28747,5991,5109,27951,122066,62049,0,0
252,33739,31249,5788,5562,28177,124556,61823,0,0
253,33885,34341,5708,5986,27899,124100,62101,0,0
254,33695,33101,5796,5710,27985,124694,62015,0,0
255,33618,41019,5633,7003,26615,117293,63385,0,0
256,32557,30146,5942,5215,27342,119704,62658,0,0
257,33142,24947,5800,4493,28649,127899,61351,0,0
258,34440,41434,5791,7029,27411,120905,62589,0,0
259,33187,30791,5776,5383,27804,123301,62196,0,0
260,33614,41388,5810,7062,26552,115527,63448,0,0
261,32280,25825,5728,4495,27785,121982,62215,0,0
262,33602,31601,5817,5492,28110,123983,61890,0,0
263,34037,36683,5927,6374,27663,121337,62337,0,0
264,33542,32920,5879,5702,27840,121959,62160,0,0
265,33626,38176,5786,6530,27096,117409,62904,0,0
266,32930,30060,5834,5393,27537,120279,62463,0,0
267,33367,26614,5830,4677,28690,127032,61310,0,0
268,34437,38414,5747,6698,27739,123055,62261,0,0
269,33635,37653,5896,6496,27139,119037,62861,0,0
270,33016,34177,5877,5891,27125,117876,62875,0,0
271,32985,35249,5860,6147,26838,115612,63162,0,0
272,32601,28483,5763,5053,27548,119730,62452,0,0
273,33396,32866,5848,5779,27617,120260,62383,0,0
274,33372,28599,5755,5067,28305,125033,61695,0,0
275,34027,38898,5722,6781,27246,120162,62754,0,0
276,33117,31789,5871,5552,27565,121490,62435,0,0
277,33412,31721,5847,5548,27864,123181,62136,0,0
278,33730,32016,5866,5529,28201,124895,61799,0,0
279,33976,36298,5775,6291,27685,122573,62315,0,0
280,33489,32793,5804,5645,27844,123269,62156,0,0
281,33689,29918,5845,5268,28421,127040,61579,0,0
282,34163,41874,5742,7209,26954,119329,63046,0,0
283,32848,31559,5894,5487,27361,120618,62639,0,0
284,33075,32611,5714,5497,27578,121082,62422,0,0
285,33354,31192,5776,5428,27926,123244,62074,0,0
286,33662,31232,5736,5413,28249,125674,61751,0,0
287,34091,36491,5842,6370,27721,123274,62279,0,0
288,33586,34560,5865,6001,27585,122300,62415,0,0
289,33332,31695,5747,5549,27783,123937,62217,0,0
290,33678,38739,5895,6490,27188,118876,62812,0,0
291,33163,29270,5975,5226,27937,122769,62063,0,0
292,33734,33684,5797,5865,27869,122819,62131,0,0
293,33741,39465,5872,6833,26908,117095,63092,0,0
294,32747,28454,5839,4948,27799,121388,62201,0,0
295,33480,36536,5681,6185,27295,118332,62705,0,0
296,33126,32350,5831,5695,27431,119108,62569,0,0
297,33314,27418,5883,4822,28492,125004,61508,0,0
298,34324,31550,5832,5618,28706,127778,61294,0,0
299,34532,39046,5826,6772,27760,123264,62240,0,0
300,33575,34353,5815,5842,27733,122486,62267,0,0
301,33488,31883,5755,5612,27876,124091,62124,0,0
302,33730,32134,5854,5581,28149,125687,61851,0,0
303,33953,39332,5804,6667,27286,120308,62714,0,0
304,33173,35591,5887,6087,27086,117890,62914,0,0
305,32892,36275,5806,6303,26589,114507,63411,0,0
306,32509,29389,5920,5265,27244,117627,62756,0,0
307,33129,28347,5885,4993,28136,122409,61864,0,0
308,33951,31555,5815,5603,28348,124805,61652,0,0
309,34181,27473,5833,4788,29393,131513,60607,0,0
310,35134,38110,5741,6553,28581,128537,61419,0,0
311,34143,40165,5562,6758,27385,122515,62615,0,0
312,33134,28423,5749,5010,28124,127226,61876,0,0
313,33919,46357,5795,7804,26115,114788,63885,0,0
314,31990,27815,5875,4841,27149,118963,62851,0,0
315,33011,33445,5862,5692,27319,118529,62681,0,0
316,33061,36233,5742,6188,26873,115357,63127,0,0
317,32681,30163,5808,5315,27366,117875,62634,0,0
318,33223,32870,5857,5764,27459,118228,62541,0,0
319,33296,29499,5837,5321,27975,122025,62025,0,0
320,33761,31096,5786,5436,28325,124690,61675,0,0
321,34173,40114,5848,7089,27084,118749,62916,0,0
322,32865,29559,5781,5289,27576,122055,62424,0,0
323,33302,35474,5726,6124,27178,119883,62822,0,0
324,33051,30636,5873,5330,27721,122298,62279,0,0
325,33505,34107,5784,5880,27625,121696,62375,0,0
326,33501,30913,5876,5339,28162,124284,61838,0,0
327,33845,33437,5683,5917,27928,124692,62072,0,0
328,33681,30000,5753,5125,28556,128373,61444,0,0
329,34429,36095,5873,6064,28365,126707,61635,0,0
330,34126,37911,5761,6534,27592,122922,62408,0,0
331,33389,36942,5797,6288,27101,119369,62899,0,0
332,32881,31605,5780,5489,27392,120645,62608,0,0
333,33225,35571,5833,6015,27210,118299,62790,0,0
334,33003,29426,5793,5148,27855,121876,62145,0,0
335,33611,37472,5756,6352,27259,118015,62741,0,0
336,33065,24992,5806,4449,28616,126088,61384,0,0
337,34488,33623,5872,5885,28603,126953,61397,0,0
338,34410,34045,5807,5837,28573,127318,61427,0,0
339,34312,35752,5739,6163,28149,125878,61851,0,0
340,34014,38441,5865,6677,27337,121451,62663,0,0
341,33169,28291,5832,4885,28284,126329,61716,0,0
342,33984,38087,5700,6538,27446,122226,62554,0,0
343,33375,38663,5929,6540,26835,116938,63165,0,0
344,32644,29844,5809,5217,27427,119738,62573,0,0
345,33112,28592,5685,5101,28011,124258,61989,0,0
346,33780,36031,5769,6081,27699,122007,62301,0,0
347,33490,33581,5791,5837,27653,121916,62347,0,0
348,33480,37686,5827,6433,27047,117710,62953,0,0
349,32784,25006,5737,4542,28242,125488,61758,0,0
350,34009,33434,5767,5745,28264,126063,61736,0,0
351,34095,35753,5831,6238,27857,124405,62143,0,0
352,33736,39546,5879,6575,27161,118595,62839,0,0
353,32924,26128,5763,4630,28294,125391,61706,0,0
354,34173,36095,5879,6183,27990,123469,62010,0,0
355,33762,32954,5772,5629,28133,124277,61867,0,0
356,34029,33444,5896,5883,28146,124862,61854,0,0
357,33936,37653,5790,6397,27539,121145,62461,0,0
358,33291,36053,5752,6282,27009,118383,62991,0,0
359,32785,34164,5776,5850,26935,117004,63065,0,0
360,32790,30657,5855,5315,27475,119137,62525,0,0
361,33256,32474,5781,5650,27606,119919,62394,0,0
362,33489,30373,5883,5452,28037,123035,61963,0,0
363,28892,30150,855,4862,24030,121777,65970,0,0
364,24881,24056,851,3594,21287,122602,68713,0,0
365,22106,23038,819,3289,18817,121670,71183,0,0
366,19700,25179,883,3229,16471,116191,73529,0,0
367,17311,22198,840,2717,14594,111304,75406,0,0
368,15367,13524,773,1599,13768,113147,76232,0,0
369,14557,17967,789,1951,12606,109737,77394,0,0
370,13329,16926,723,1752,11577,106140,78423,0,0
371,12308,12942,731,1319,10989,105506,79011,0,0
372,11715,15049,726,1492,10223,102172,79777,0,0
373,10972,12977,749,1256,9716,100167,80284,0,0
374,10441,11517,725,1080,9361,99091,80639,0,0
375,10010,11323,649,1052,8958,97778,81042,0,0
376,9608,12263,650,1075,8533,95123,81467,0,0
377,9138,9933,605,885,8253,94328,81747,0,0
378,8848,9343,595,810,8038,93833,81962,0,0
379,8692,13522,654,1139,7553,89003,82447,0,0
380,8117,11225,564,921,7196,85895,82804,0,0
381,7726,8877,530,740,6986,84744,83014,0,0
382,7502,11855,516,926,6576,80391,83424,0,0
383,7056,7425,480,598,6458,80022,83542,0,0
384,6910,7925,452,647,6263,79007,83737,0,0
385,6674,7840,411,631,6043,77841,83957,0,0
386,6469,10650,426,826,5643,73660,84357,0,0
387,6037,8516,394,651,5386,71181,84614,0,0
388,5729,8251,343,579,5150,68659,84850,0,0
389,5509,5983,359,458,5051,68185,84949,0,0
390,5406,7773,355,550,4856,65818,85144,0,0
391,5171,8049,315,577,4594,62940,85406,0,0
392,4894,7203,300,513,4381,60631,85619,0,0
393,4642,7778,261,529,4113,57495,85887,0,0
394,4356,7095,243,464,3892,54756,86108,0,0
395,4165,6912,273,496,3669,52009,86331,0,0
396,3880,5949,211,401,3479,49940,86521,0,0
397,3695,7036,216,483,3212,46599,86788,0,0
398,3418,7832,206,498,2920,42185,87080,0,0
399,3095,5676,175,398,2697,39604,87303,0,0
400,2858,4514,161,316,2542,37948,87458,0,0
401,2678,5107,136,328,2350,35519,87650,0,0
402,2475,4112,125,256,2219,33882,87781,0,0
403,2349,4782,130,320,2029,31449,87971,0,0
404,2156,5427,127,341,1815,28178,88185,0,0
405,1912,3701,97,230,1682,26389,88318,0,0
406,1779,3321,97,198,1581,24847,88419,0,0
407,1679,4260,98,269,1410,22266,88590,0,0
408,1484,1459,74,86,1398,22291,88602,0,0
409,1481,3107,83,196,1285,20665,88715,0,0
410,1348,3189,63,197,1151,18824,88849,0,0
411,1208,1622,57,100,1108,18410,88892,0,0
412,1175,2390,67,130,1045,17195,88955,0,0
413,1105,2989,60,170,935,15311,89065,0,0
414,992,2527,57,139,853,13776,89147,0,0
415,894,2414,41,140,754,12256,89246,0,0
416,797,1921,43,110,687,11132,89313,0,0
417,724,1922,37,109,615,9934,89385,0,0
418,653,1292,38,80,573,9295,89427,0,0
419,598,1341,25,78,520,8552,89480,0,0
420,558,1294,38,81,477,7816,89523,0,0
421,502,717,25,41,461,7601,89539,0,0
422,492,402,31,21,471,7691,89529,0,0
423,492,388,21,26,466,7795,89534,0,0
424,491,2851,25,142,349,5435,89651,0,0
425,360,311,11,24,336,5484,89664,0,0
426,351,1491,15,73,278,4344,89722,0,0
427,295,205,17,15,280,4434,89720,0,0
428,296,87,16,6,290,4643,89710,0,0
429,310,0,20,0,310,4953,89690,0,0
430,320,438,10,32,288,4835,89712,0,0
431,307,410,19,20,287,4732,89713,0,0
432,306,0,19,0,306,5038,89694,0,0
433,320,0,14,0,320,5358,89680,0,0
434,337,0,17,0,337,5695,89663,0,0
435,353,0,16,0,353,6048,89647,0,0
436,371,0,18,0,371,6419,89629,0,0
437,392,0,21,0,392,6811,89608,0,0
438,405,0,13,0,405,7216,89595,0,0
439,423,0,18,0,423,7639,89577,0,0
440,446,0,23,0,446,8085,89554,0,0
441,467,0,21,0,467,8552,89533,0,0
442,486,0,19,0,486,9038,89514,0,0
443,516,0,30,0,516,9554,89484,0,0
444,537,0,21,0,537,10091,89463,0,0
445,558,0,21,0,558,10649,89442,0,0
446,578,0,20,0,578,11227,89422,0,0
447,595,0,17,0,595,11822,89405,0,0
448,626,0,31,0,626,12448,89374,0,0
449,656,0,30,0,656,13104,89344,0,0
450,683,0,27,0,683,13787,89317,0,0
451,710,0,27,0,710,14497,89290,0,0
452,746,0,36,0,746,15243,89254,0,0
453,774,0,28,0,774,16017,89226,0,0
454,805,0,31,0,805,16822,89195,0,0
455,832,0,27,0,832,17654,89168,0,0
456,863,0,31,0,863,18517,89137,0,0
457,892,0,29,0,892,19409,89108,0,0
458,920,0,28,0,920,20329,89080,0,0
459,963,0,43,0,963,21292,89037,0,0
460,992,0,29,0,992,22284,89008,0,0
461,1023,0,31,0,1023,23307,88977,0,0
462,1057,0,34,0,1057,24364,88943,0,0
463,1087,0,30,0,1087,25451,88913,0,0
464,1131,0,44,0,1131,26582,88869,0,0
465,1180,0,49,0,1180,27762,88820,0,0
466,1214,0,34,0,1214,28976,88786,0,0
467,1247,0,33,0,1247,30223,88753,0,0
468,1286,0,39,0,1286,31509,88714,0,0
469,1328,0,42,0,1328,32837,88672,0,0
470,1386,0,58,0,1386,34223,88614,0,0
471,1427,0,41,0,1427,35650,88573,0,0
472,1474,0,47,0,1474,37124,88526,0,0
473,1521,0,47,0,1521,38645,88479,0,0
474,1559,0,38,0,1559,40204,88441,0,0
475,1602,0,43,0,1602,41806,88398,0,0
476,1644,0,42,0,1644,43450,88356,0,0
477,1691,0,47,0,1691,45141,88309,0,0
478,1734,0,43,0,1734,46875,88266,0,0
479,1767,0,33,0,1767,48642,88233,0,0
480,1818,0,51,0,1818,50460,88182,0,0
481,1867,0,49,0,1867,52327,88133,0,0
482,1914,0,47,0,1914,54241,88086,0,0
483,1979,0,65,0,1979,56220,88021,0,0
484,2031,0,52,0,2031,58251,87969,0,0
485,2077,0,46,0,2077,60328,87923,0,0
486,2125,0,48,0,2125,62453,87875,0,0
487,2178,0,53,0,2178,64631,87822,0,0
488,2216,0,38,0,2216,66847,87784,0,0
489,2258,0,42,0,2258,69105,87742,0,0
490,2330,0,72,0,2330,71435,87670,0,0
491,2381,0,51,0,2381,73816,87619,0,0
492,2438,0,57,0,2438,76254,87562,0,0
493,2496,0,58,0,2496,78750,87504,0,0
494,2556,0,60,0,2556,81306,87444,0,0
495,2619,0,63,0,2619,83925,87381,0,0
496,2669,0,50,0,2669,86594,87331,0,0
497,2725,0,56,0,2725,89319,87275,0,0
498,2785,0,60,0,2785,92104,87215,0,0
499,2855,0,70,0,2855,94959,87145,0,0
500,2915,0,60,0,2915,97874,87085,0,0
501,2975,0,60,0,2975,100849,87025,0,0
502,3035,6639,60,191,2844,97245,87156,0,0
503,2907,0,63,0,2907,100152,87093,0,0
504,2973,0,66,0,2973,103125,87027,0,0
505,3029,0,56,0,3029,106154,86971,0,0
506,3082,0,53,0,3082,109236,86918,0,0
507,3156,0,74,0,3156,112392,86844,0,0
508,3216,0,60,0,3216,115608,86784,0,0
509,3295,0,79,0,3295,118903,86705,0,0
510,3356,0,61,0,3356,122259,86644,0,0
511,3413,0,57,0,3413,125672,86587,0,0
512,3478,0,65,0,3478,129150,86522,0,0
513,3540,0,62,0,3540,132690,86460,0,0
514,3613,22362,73,592,3021,113941,86979,0,0
515,3076,0,55,0,3076,117017,86924,0,0
516,3126,0,50,0,3126,120143,86874,0,0
517,3173,0,47,0,3173,123316,86827,0,0
518,3237,0,64,0,3237,126553,86763,0,0
519,3310,0,73,0,3310,129863,86690,0,0
520,3361,0,51,0,3361,133224,86639,0,0
521,3424,0,63,0,3424,136648,86576,0,0
522,3492,0,68,0,3492,140140,86508,0,0
523,3550,0,58,0,3550,143690,86450,0,0
524,3604,0,54,0,3604,147294,86396,0,0
525,3674,0,70,0,3674,150968,86326,0,0
526,3730,0,56,0,3730,154698,86270,0,0
527,3793,0,63,0,3793,158491,86207,0,0
528,3860,0,67,0,3860,162351,86140,0,0
529,3912,0,52,0,3912,166263,86088,0,0
530,3977,0,65,0,3977,170240,86023,0,0
531,4036,0,59,0,4036,174276,85964,0,0
532,4097,0,61,0,4097,178373,85903,0,0
533,4164,0,67,0,4164,182537,85836,0,0
534,4244,0,80,0,4244,186781,85756,0,0
535,4321,0,77,0,4321,191102,85679,0,0
536,4397,0,76,0,4397,195499,85603,0,0
537,4462,0,65,0,4462,199961,85538,0,0
538,4532,0,70,0,4532,204493,85468,0,0
539,4590,0,58,0,4590,209083,85410,0,0
540,4676,0,86,0,4676,213759,85324,0,0
541,4746,0,70,0,4746,218505,85254,0,0
542,4793,0,47,0,4793,223298,85207,0,0
543,4869,0,76,0,4869,228167,85131,0,0
544,4949,0,80,0,4949,233116,85051,0,0
545,5016,0,67,0,5016,238132,84984,0,0
546,5085,0,69,0,5085,243217,84915,0,0
547,5154,0,69,0,5154,248371,84846,0,0
548,5241,0,87,0,5241,253612,84759,0,0
549,5317,0,76,0,5317,258929,84683,0,0
550,5389,0,72,0,5389,264318,84611,0,0
551,5456,0,67,0,5456,269774,84544,0,0
552,5538,0,82,0,5538,275312,84462,0,0
553,5610,0,72,0,5610,280922,84390,0,0
554,5699,0,89,0,5699,286621,84301,0,0
555,5764,0,65,0,5764,292385,84236,0,0
556,5839,0,75,0,5839,298224,84161,0,0
557,5924,0,85,0,5924,304148,84076,0,0
558,6003,0,79,0,6003,310151,83997,0,0
559,6075,0,72,0,6075,316226,83925,0,0
560,6146,0,71,0,6146,322372,83854,0,0
561,6209,0,63,0,6209,328581,83791,0,0
562,6291,0,82,0,6291,334872,83709,0,0
563,6394,0,103,0,6394,341266,83606,0,0
564,6475,0,81,0,6475,347741,83525,0,0
565,6564,0,89,0,6564,354305,83436,0,0
566,6648,0,84,0,6648,360953,83352,0,0
567,6720,0,72,0,6720,367673,83280,0,0
568,6787,0,67,0,6787,374460,83213,0,0
569,6871,0,84,0,6871,381331,83129,0,0
570,6949,0,78,0,6949,388280,83051,0,0
571,7025,13433,76,265,6760,381872,83240,0,0
572,6838,0,78,0,6838,388710,83162,0,0
573,6925,0,87,0,6925,395635,83075,0,0
574,6992,0,67,0,6992,402627,83008,0,0
575,7080,0,88,0,7080,409707,82920,0,0
576,7169,0,89,0,7169,416876,82831,0,0
577,7249,0,80,0,7249,424125,82751,0,0
578,7335,0,86,0,7335,431460,82665,0,0
579,7404,0,69,0,7404,438864,82596,0,0
580,7488,0,84,0,7488,446352,82512,0,0
581,7595,0,107,0,7595,453947,82405,0,0
582,7670,0,75,0,7670,461617,82330,0,0
583,7756,0,86,0,7756,469373,82244,0,0
584,7831,0,75,0,7831,477204,82169,0,0
585,7904,0,73,0,7904,485108,82096,0,0
586,7986,0,82,0,7986,493094,82014,0,0
587,8071,0,85,0,8071,501165,81929,0,0
588,8155,0,84,0,8155,509320,81845,0,0
589,8233,0,78,0,8233,517553,81767,0,0
590,8310,0,77,0,8310,525863,81690,0,0
591,8395,0,85,0,8395,534258,81605,0,0
592,8483,0,88,0,8483,542741,81517,0,0
593,8563,0,80,0,8563,551304,81437,0,0
594,8658,0,95,0,8658,559962,81342,0,0
595,8747,0,89,0,8747,568709,81253,0,0
596,8826,0,79,0,8826,577535,81174,0,0
597,8915,0,89,0,8915,586450,81085,0,0
598,9007,0,92,0,9007,595457,80993,0,0
599,9092,0,85,0,9092,604549,80908,0,0
600,9184,0,92,0,9184,613733,80816,0,0
601,9271,0,87,0,9271,623004,80729,0,0
602,9370,128823,99,1907,7463,503551,82537,0,0
603,7537,0,74,0,7537,511088,82463,0,0
604,7618,0,81,0,7618,518706,82382,0,0
605,7698,0,80,0,7698,526404,82302,0,0
606,7776,29866,78,438,7338,504314,82662,0,0
607,7417,0,79,0,7417,511731,82583,0,0
608,7476,0,59,0,7476,519207,82524,0,0
609,7531,0,55,0,7531,526738,82469,0,0
610,7593,0,62,0,7593,534331,82407,0,0
611,7662,0,69,0,7662,541993,82338,0,0
612,7725,0,63,0,7725,549718,82275,0,0
613,7790,0,65,0,7790,557508,82210,0,0
614,7853,0,63,0,7853,565361,82147,0,0
615,7932,0,79,0,7932,573293,82068,0,0
616,7989,0,57,0,7989,581282,82011,0,0
617,8056,0,67,0,8056,589338,81944,0,0
618,8127,0,71,0,8127,597465,81873,0,0
619,8198,0,71,0,8198,605663,81802,0,0
620,8275,0,77,0,8275,613938,81725,0,0
621,8341,0,66,0,8341,622279,81659,0,0
622,8420,0,79,0,8420,630699,81580,0,0
623,8489,0,69,0,8489,639188,81511,0,0
624,8563,0,74,0,8563,647751,81437,0,0
625,8643,0,80,0,8643,656394,81357,0,0
626,8727,0,84,0,8727,665121,81273,0,0
627,8811,0,84,0,8811,673932,81189,0,0
628,8886,0,75,0,8886,682818,81114,0,0
629,8958,0,72,0,8958,691776,81042,0,0
630,9028,123808,70,1540,7488,576996,82512,0,0
631,7545,0,57,0,7545,584541,82455,0,0
632,7610,0,65,0,7610,592151,82390,0,0
633,7680,0,70,0,7680,599831,82320,0,0
634,7752,0,72,0,7752,607583,82248,0,0
635,7810,0,58,0,7810,615393,82190,0,0
636,7878,0,68,0,7878,623271,82122,0,0
637,7947,0,69,0,7947,631218,82053,0,0
638,8001,0,54,0,8001,639219,81999,0,0
639,8061,0,60,0,8061,647280,81939,0,0
640,8114,0,53,0,8114,655394,81886,0,0
641,8191,0,77,0,8191,663585,81809,0,0
642,8257,0,66,0,8257,671842,81743,0,0
643,8334,0,77,0,8334,680176,81666,0,0
644,8391,0,57,0,8391,688567,81609,0,0
645,8451,0,60,0,8451,697018,81549,0,0
646,8507,0,56,0,8507,705525,81493,0,0
647,8572,0,65,0,8572,714097,81428,0,0
648,8630,0,58,0,8630,722727,81370,0,0
649,8692,0,62,0,8692,731419,81308,0,0
650,8769,0,77,0,8769,740188,81231,0,0
651,8833,0,64,0,8833,749021,81167,0,0
652,8922,0,89,0,8922,757943,81078,0,0
653,8996,0,74,0,8996,766939,81004,0,0
654,9047,0,51,0,9047,775986,80953,0,0
655,9135,0,88,0,9135,785121,80865,0,0
656,9195,0,60,0,9195,794316,80805,0,0
657,9276,0,81,0,9276,803592,80724,0,0
658,9346,0,70,0,9346,812938,80654,0,0
659,9413,0,67,0,9413,822351,80587,0,0
660,9475,0,62,0,9475,831826,80525,0,0
661,9550,0,75,0,9550,841376,80450,0,0
662,9613,0,63,0,9613,850989,80387,0,0
663,9681,0,68,0,9681,860670,80319,0,0
664,9762,0,81,0,9762,870432,80238,0,0
665,9839,213960,77,2410,7429,666311,82571,0,0
666,7479,0,50,0,7479,673790,82521,0,0
667,7539,0,60,0,7539,681329,82461,0,0
668,7589,0,50,0,7589,688918,82411,0,0
669,7650,0,61,0,7650,696568,82350,0,0
670,7707,0,57,0,7707,704275,82293,0,0
671,7768,0,61,0,7768,712043,82232,0,0
672,7831,0,63,0,7831,719874,82169,0,0
673,7890,0,59,0,7890,727764,82110,0,0
674,7961,0,71,0,7961,735725,82039,0,0
675,8019,0,58,0,8019,743744,81981,0,0
676,8066,0,47,0,8066,751810,81934,0,0
677,8125,0,59,0,8125,759935,81875,0,0
678,8180,0,55,0,8180,768115,81820,0,0
679,8248,0,68,0,8248,776363,81752,0,0
680,8308,0,60,0,8308,784671,81692,0,0
681,8370,0,62,0,8370,793041,81630,0,0
682,8432,0,62,0,8432,801473,81568,0,0
683,8500,77844,68,891,7609,732129,82391,0,0
684,7666,0,57,0,7666,739795,82334,0,0
685,7710,0,44,0,7710,747505,82290,0,0
686,7760,0,50,0,7760,755265,82240,0,0
687,7801,225053,41,2134,5667,538013,84333,0,0
688,5714,0,47,0,5714,543727,84286,0,0
689,5751,0,37,0,5751,549478,84249,0,0
690,5792,0,41,0,5792,555270,84208,0,0
691,5846,0,54,0,5846,561116,84154,0,0
692,5894,0,48,0,5894,567010,84106,0,0
693,5928,0,34,0,5928,572938,84072,0,0
694,5981,0,53,0,5981,578919,84019,0,0
695,6025,0,44,0,6025,584944,83975,0,0
696,6076,0,51,0,6076,591020,83924,0,0
697,6128,0,52,0,6128,597148,83872,0,0
698,6156,0,28,0,6156,603304,83844,0,0
699,6211,0,55,0,6211,609515,83789,0,0
700,6257,0,46,0,6257,615772,83743,0,0
701,6299,0,42,0,6299,622071,83701,0,0
702,6349,133328,50,1323,5026,495092,84974,0,0
703,5067,0,41,0,5067,500159,84933,0,0
704,5115,0,48,0,5115,505274,84885,0,0
705,5152,0,37,0,5152,510426,84848,0,0
706,5188,0,36,0,5188,515614,84812,0,0
707,5228,0,40,0,5228,520842,84772,0,0
708,5268,0,40,0,5268,526110,84732,0,0
709,5306,0,38,0,5306,531416,84694,0,0
710,5355,0,49,0,5355,536771,84645,0,0
711,5399,0,44,0,5399,542170,84601,0,0
712,5449,0,50,0,5449,547619,84551,0,0
713,5489,0,40,0,5489,553108,84511,0,0
714,5523,0,34,0,5523,558631,84477,0,0
715,5558,0,35,0,5558,564189,84442,0,0
716,5595,0,37,0,5595,569784,84405,0,0
717,5646,0,51,0,5646,575430,84354,0,0
718,5687,0,41,0,5687,581117,84313,0,0
719,5738,0,51,0,5738,586855,84262,0,0
720,5776,0,38,0,5776,592631,84224,0,0
721,5824,263729,48,2239,3585,334726,86415,0,0
722,3615,0,30,0,3615,338341,86385,0,0
723,3654,0,39,0,3654,341995,86346,0,0
724,3676,0,22,0,3676,345671,86324,0,0
725,3709,0,33,0,3709,349380,86291,0,0
726,3730,0,21,0,3730,353110,86270,0,0
727,3768,0,38,0,3768,356878,86232,0,0
728,3808,0,40,0,3808,360686,86192,0,0
729,3842,0,34,0,3842,364528,86158,0,0
730,3877,0,35,0,3877,368405,86123,0,0
731,3911,0,34,0,3911,372316,86089,0,0
732,3939,0,28,0,3939,376255,86061,0,0
733,3976,0,37,0,3976,380231,86024,0,0
734,4017,0,41,0,4017,384248,85983,0,0
735,4065,0,48,0,4065,388313,85935,0,0
736,4100,0,35,0,4100,392413,85900,0,0
737,4136,0,36,0,4136,396549,85864,0,0
738,4183,0,47,0,4183,400732,85817,0,0
739,4224,0,41,0,4224,404956,85776,0,0
740,4253,0,29,0,4253,409209,85747,0,0
741,4289,0,36,0,4289,413498,85711,0,0
742,4322,93715,33,817,3505,324105,86495,0,0
743,3537,178371,32,1563,1974,149271,88026,0,0
744,1997,0,23,0,1997,151268,88003,0,0
745,2016,0,19,0,2016,153284,87984,0,0
746,2041,0,25,0,2041,155325,87959,0,0
747,2066,0,25,0,2066,157391,87934,0,0
748,2098,0,32,0,2098,159489,87902,0,0
749,2116,0,18,0,2116,161605,87884,0,0
750,2137,0,21,0,2137,163742,87863,0,0
751,2161,0,24,0,2161,165903,87839,0,0
752,2183,0,22,0,2183,168086,87817,0,0
753,2208,0,25,0,2208,170294,87792,0,0
754,2231,0,23,0,2231,172525,87769,0,0
755,2265,0,34,0,2265,174790,87735,0,0
756,2301,0,36,0,2301,177091,87699,0,0
757,2330,0,29,0,2330,179421,87670,0,0
758,2369,13194,39,257,2112,168596,87888,0,0
759,2135,0,23,0,2135,170731,87865,0,0
760,2164,0,29,0,2164,172895,87836,0,0
761,2189,0,25,0,2189,175084,87811,0,0
762,2213,0,24,0,2213,177297,87787,0,0
763,2232,0,19,0,2232,179529,87768,0,0
764,2258,0,26,0,2258,181787,87742,0,0
765,2280,0,22,0,2280,184067,87720,0,0
766,2311,0,31,0,2311,186378,87689,0,0
767,2332,0,21,0,2332,188710,87668,0,0
768,2354,0,22,0,2354,191064,87646,0,0
769,2381,0,27,0,2381,193445,87619,0,0
770,2399,0,18,0,2399,195844,87601,0,0
771,2423,0,24,0,2423,198267,87577,0,0
772,2449,0,26,0,2449,200716,87551,0,0
773,2478,0,29,0,2478,203194,87522,0,0
774,2502,0,24,0,2502,205696,87498,0,0
775,2524,0,22,0,2524,208220,87476,0,0
776,2546,0,22,0,2546,210766,87454,0,0
777,2566,0,20,0,2566,213332,87434,0,0
778,2590,0,24,0,2590,215922,87410,0,0
779,2619,0,29,0,2619,218541,87381,0,0
780,2637,169151,18,1496,1141,52027,88859,0,0
781,1159,0,18,0,1159,53186,88841,0,0
782,1183,0,24,0,1183,54369,88817,0,0
783,1202,0,19,0,1202,55571,88798,0,0
784,1224,0,22,0,1224,56795,88776,0,0
785,1246,0,22,0,1246,58041,88754,0,0
786,1259,0,13,0,1259,59300,88741,0,0
787,1280,0,21,0,1280,60580,88720,0,0
788,1297,0,17,0,1297,61877,88703,0,0
789,1316,0,19,0,1316,63193,88684,0,0
790,1333,0,17,0,1333,64526,88667,0,0
791,1351,0,18,0,1351,65877,88649,0,0
792,1366,0,15,0,1366,67243,88634,0,0
793,1382,0,16,0,1382,68625,88618,0,0
794,1401,0,19,0,1401,70026,88599,0,0
795,1426,0,25,0,1426,71452,88574,0,0
796,1442,0,16,0,1442,72894,88558,0,0
797,1470,0,28,0,1470,74364,88530,0,0
798,1484,0,14,0,1484,75848,88516,0,0
799,1500,0,16,0,1500,77348,88500,0,0
800,1521,0,21,0,1521,78869,88479,0,0
801,1540,0,19,0,1540,80409,88460,0,0
802,1563,0,23,0,1563,81972,88437,0,0
803,1584,0,21,0,1584,83556,88416,0,0
804,1599,0,15,0,1599,85155,88401,0,0
805,1609,0,10,0,1609,86764,88391,0,0
806,1621,0,12,0,1621,88385,88379,0,0
807,1642,0,21,0,1642,90027,88358,0,0
808,1665,0,23,0,1665,91692,88335,0,0
809,1684,0,19,0,1684,93376,88316,0,0
810,1709,0,25,0,1709,95085,88291,0,0
811,1727,0,18,0,1727,96812,88273,0,0
812,1745,0,18,0,1745,98557,88255,0,0
813,1769,63492,24,1047,722,36834,89278,0,0
814,736,0,14,0,736,37570,89264,0,0
815,747,0,11,0,747,38317,89253,0,0
816,754,0,7,0,754,39071,89246,0,0
817,768,0,14,0,768,39839,89232,0,0
818,779,0,11,0,779,40618,89221,0,0
819,789,0,10,0,789,41407,89211,0,0
820,800,0,11,0,800,42207,89200,0,0
821,812,0,12,0,812,43019,89188,0,0
822,827,0,15,0,827,43846,89173,0,0
823,834,0,7,0,834,44680,89166,0,0
824,847,0,13,0,847,45527,89153,0,0
825,866,0,19,0,866,46393,89134,0,0
826,875,0,9,0,875,47268,89125,0,0
827,887,0,12,0,887,48155,89113,0,0
828,897,0,10,0,897,49052,89103,0,0
829,900,0,3,0,900,49952,89100,0,0
830,911,0,11,0,911,50863,89089,0,0
831,921,0,10,0,921,51784,89079,0,0
832,934,0,13,0,934,52718,89066,0,0
833,947,0,13,0,947,53665,89053,0,0
834,961,0,14,0,961,54626,89039,0,0
835,971,0,10,0,971,55597,89029,0,0
836,984,0,13,0,984,56581,89016,0,0
837,999,0,15,0,999,57580,89001,0,0
838,1008,0,9,0,1008,58588,88992,0,0
839,1018,0,10,0,1018,59606,88982,0,0
840,1031,0,13,0,1031,60637,88969,0,0
841,1046,0,15,0,1046,61683,88954,0,0
842,1054,0,8,0,1054,62737,88946,0,0
843,1071,0,17,0,1071,63808,88929,0,0
844,1082,0,11,0,1082,64890,88918,0,0
845,1094,0,12,0,1094,65984,88906,0,0
846,1105,0,11,0,1105,67089,88895,0,0
847,1114,0,9,0,1114,68203,88886,0,0
848,1126,0,12,0,1126,69329,88874,0,0
849,1137,0,11,0,1137,70466,88863,0,0
850,1153,0,16,0,1153,71619,88847,0,0
851,1171,0,18,0,1171,72790,88829,0,0
852,1182,0,11,0,1182,73972,88818,0,0
853,1195,0,13,0,1195,75167,88805,0,0
854,1209,0,14,0,1209,76376,88791,0,0
855,1225,0,16,0,1225,77601,88775,0,0
856,1234,0,9,0,1234,78835,88766,0,0
857,1250,0,16,0,1250,80085,88750,0,0
858,1265,0,15,0,1265,81350,88735,0,0
859,1279,0,14,0,1279,82629,88721,0,0
860,1294,0,15,0,1294,83923,88706,0,0
861,1303,0,9,0,1303,85226,88697,0,0
862,1316,0,13,0,1316,86542,88684,0,0
863,1328,0,12,0,1328,87870,88672,0,0
864,1344,0,16,0,1344,89214,88656,0,0
865,1360,0,16,0,1360,90574,88640,0,0
866,1371,0,11,0,1371,91945,88629,0,0
867,1384,0,13,0,1384,93329,88616,0,0
868,1394,0,10,0,1394,94723,88606,0,0
869,1408,0,14,0,1408,96131,88592,0,0
870,1430,0,22,0,1430,97561,88570,0,0
871,1448,0,18,0,1448,99009,88552,0,0
872,1469,0,21,0,1469,100478,88531,0,0
873,1483,0,14,0,1483,101961,88517,0,0
874,1504,0,21,0,1504,103465,88496,0,0
875,1522,0,18,0,1522,104987,88478,0,0
876,1534,0,12,0,1534,106521,88466,0,0
877,1548,0,14,0,1548,108069,88452,0,0
878,1564,0,16,0,1564,109633,88436,0,0
879,1578,0,14,0,1578,111211,88422,0,0
880,1590,0,12,0,1590,112801,88410,0,0
881,1606,0,16,0,1606,114407,88394,0,0
882,1618,0,12,0,1618,116025,88382,0,0
883,1644,0,26,0,1644,117669,88356,0,0
884,1661,0,17,0,1661,119330,88339,0,0
885,1666,0,5,0,1666,120996,88334,0,0
886,1681,0,15,0,1681,122677,88319,0,0
887,1696,0,15,0,1696,124373,88304,0,0
888,1708,0,12,0,1708,126081,88292,0,0
889,1722,0,14,0,1722,127803,88278,0,0
890,1744,0,22,0,1744,129547,88256,0,0
891,1763,0,19,0,1763,131310,88237,0,0
892,1782,0,19,0,1782,133092,88218,0,0
893,1799,0,17,0,1799,134891,88201,0,0
894,1815,0,16,0,1815,136706,88185,0,0
895,1835,0,20,0,1835,138541,88165,0,0
896,1850,0,15,0,1850,140391,88150,0,0
897,1863,0,13,0,1863,142254,88137,0,0
898,1880,48592,17,637,1243,95542,88757,0,0
899,1251,0,8,0,1251,96793,88749,0,0
900,1268,0,17,0,1268,98061,88732,0,0
901,1281,0,13,0,1281,99342,88719,0,0
902,1296,0,15,0,1296,100638,88704,0,0
903,1303,0,7,0,1303,101941,88697,0,0
904,1314,0,11,0,1314,103255,88686,0,0
905,1324,0,10,0,1324,104579,88676,0,0
906,1335,0,11,0,1335,105914,88665,0,0
907,1350,0,15,0,1350,107264,88650,0,0
908,1358,0,8,0,1358,108622,88642,0,0
909,1370,0,12,0,1370,109992,88630,0,0
910,1385,0,15,0,1385,111377,88615,0,0
911,1395,0,10,0,1395,112772,88605,0,0
912,1405,0,10,0,1405,114177,88595,0,0
913,1420,0,15,0,1420,115597,88580,0,0
914,1439,0,19,0,1439,117036,88561,0,0
915,1457,0,18,0,1457,118493,88543,0,0
916,1467,0,10,0,1467,119960,88533,0,0
917,1478,0,11,0,1478,121438,88522,0,0
918,1489,0,11,0,1489,122927,88511,0,0
919,1499,0,10,0,1499,124426,88501,0,0
920,1505,0,6,0,1505,125931,88495,0,0
921,1519,0,14,0,1519,127450,88481,0,0
922,1531,0,12,0,1531,128981,88469,0,0
923,1541,0,10,0,1541,130522,88459,0,0
924,1547,0,6,0,1547,132069,88453,0,0
925,1561,0,14,0,1561,133630,88439,0,0
926,1573,0,12,0,1573,135203,88427,0,0
927,1590,0,17,0,1590,136793,88410,0,0
928,1603,0,13,0,1603,138396,88397,0,0
929,1612,0,9,0,1612,140008,88388,0,0
930,1628,0,16,0,1628,141636,88372,0,0
931,1639,0,11,0,1639,143275,88361,0,0
932,1651,0,12,0,1651,144926,88349,0,0
933,1672,0,21,0,1672,146598,88328,0,0
934,1684,0,12,0,1684,148282,88316,0,0
935,1705,0,21,0,1705,149987,88295,0,0
936,1714,0,9,0,1714,151701,88286,0,0
937,1721,0,7,0,1721,153422,88279,0,0
938,1737,0,16,0,1737,155159,88263,0,0
939,1747,0,10,0,1747,156906,88253,0,0
940,1758,0,11,0,1758,158664,88242,0,0
941,1769,0,11,0,1769,160433,88231,0,0
942,1780,0,11,0,1780,162213,88220,0,0
943,1795,0,15,0,1795,164008,88205,0,0
944,1802,0,7,0,1802,165810,88198,0,0
945,1819,0,17,0,1819,167629,88181,0,0
946,1832,0,13,0,1832,169461,88168,0,0
947,1844,0,12,0,1844,171305,88156,0,0
948,1860,0,16,0,1860,173165,88140,0,0
949,1870,0,10,0,1870,175035,88130,0,0
950,1883,0,13,0,1883,176918,88117,0,0
951,1893,0,10,0,1893,178811,88107,0,0
952,1904,0,11,0,1904,180715,88096,0,0
953,1918,0,14,0,1918,182633,88082,0,0
954,1932,0,14,0,1932,184565,88068,0,0
955,1946,0,14,0,1946,186511,88054,0,0
956,1964,0,18,0,1964,188475,88036,0,0
957,1980,0,16,0,1980,190455,88020,0,0
958,1988,0,8,0,1988,192443,88012,0,0
959,2007,0,19,0,2007,194450,87993,0,0
960,2022,0,15,0,2022,196472,87978,0,0
961,2036,0,14,0,2036,198508,87964,0,0
962,2050,0,14,0,2050,200558,87950,0,0
963,2065,0,15,0,2065,202623,87935,0,0
964,2080,0,15,0,2080,204703,87920,0,0
965,2090,0,10,0,2090,206793,87910,0,0
966,2102,0,12,0,2102,208895,87898,0,0
967,2119,0,17,0,2119,211014,87881,0,0
968,2134,0,15,0,2134,213148,87866,0,0
969,2146,0,12,0,2146,215294,87854,0,0
970,2170,0,24,0,2170,217464,87830,0,0
971,2189,0,19,0,2189,219653,87811,0,0
972,2206,0,17,0,2206,221859,87794,0,0
973,2219,0,13,0,2219,224078,87781,0,0
974,2231,0,12,0,2231,226309,87769,0,0
975,2246,0,15,0,2246,228555,87754,0,0
976,2271,0,25,0,2271,230826,87729,0,0
977,2291,0,20,0,2291,233117,87709,0,0
978,2302,0,11,0,2302,235419,87698,0,0
979,2322,0,20,0,2322,237741,87678,0,0
980,2344,0,22,0,2344,240085,87656,0,0
981,2351,0,7,0,2351,242436,87649,0,0
982,2370,0,19,0,2370,244806,87630,0,0
983,2389,0,19,0,2389,247195,87611,0,0
984,2416,0,27,0,2416,249611,87584,0,0
985,2429,0,13,0,2429,252040,87571,0,0
986,2444,0,15,0,2444,254484,87556,0,0
987,2468,0,24,0,2468,256952,87532,0,0
988,2482,0,14,0,2482,259434,87518,0,0
989,2499,0,17,0,2499,261933,87501,0,0
990,2518,0,19,0,2518,264451,87482,0,0
991,2527,0,9,0,2527,266978,87473,0,0
992,2538,0,11,0,2538,269516,87462,0,0
993,2551,0,13,0,2551,272067,87449,0,0
994,2571,0,20,0,2571,274638,87429,0,0
995,2587,0,16,0,2587,277225,87413,0,0
996,2602,0,15,0,2602,279827,87398,0,0
997,2622,0,20,0,2622,282449,87378,0,0
998,2637,0,15,0,2637,285086,87363,0,0
999,2658,0,21,0,2658,287744,87342,0,0
1000,2681,0,23,0,2681,290425,87319,0,0
1001,2702,0,21,0,2702,293127,87298,0,0
1002,2730,0,28,0,2730,295857,87270,0,0
1003,2753,0,23,0,2753,298610,87247,0,0
1004,2772,0,19,0,2772,301382,87228,0,0
1005,2789,0,17,0,2789,304171,87211,0,0
1006,2805,0,16,0,2805,306976,87195,0,0
1007,2820,0,15,0,2820,309796,87180,0,0
1008,2840,0,20,0,2840,312636,87160,0,0
1009,2864,0,24,0,2864,315500,87136,0,0
1010,2881,0,17,0,2881,318381,87119,0,0
1011,2899,0,18,0,2899,321280,87101,0,0
1012,2911,0,12,0,2911,324191,87089,0,0
1013,2932,0,21,0,2932,327123,87068,0,0
1014,2942,0,10,0,2942,330065,87058,0,0
1015,2957,0,15,0,2957,333022,87043,0,0
1016,2984,0,27,0,2984,336006,87016,0,0
1017,2996,0,12,0,2996,339002,87004,0,0
1018,3014,0,18,0,3014,342016,86986,0,0
1019,3029,0,15,0,3029,345045,86971,0,0
1020,3041,0,12,0,3041,348086,86959,0,0
1021,3058,0,17,0,3058,351144,86942,0,0
1022,3079,0,21,0,3079,354223,86921,0,0
1023,3096,0,17,0,3096,357319,86904,0,0
1024,3113,0,17,0,3113,360432,86887,0,0
1025,3132,0,19,0,3132,363564,86868,0,0
1026,3151,0,19,0,3151,366715,86849,0,0
1027,3171,0,20,0,3171,369886,86829,0,0
1028,3184,0,13,0,3184,373070,86816,0,0
1029,3202,0,18,0,3202,376272,86798,0,0
1030,3222,0,20,0,3222,379494,86778,0,0
1031,3234,0,12,0,3234,382728,86766,0,0
1032,3260,0,26,0,3260,385988,86740,0,0
1033,3280,0,20,0,3280,389268,86720,0,0
1034,3297,0,17,0,3297,392565,86703,0,0
1035,3320,0,23,0,3320,395885,86680,0,0
1036,3340,0,20,0,3340,399225,86660,0,0
1037,3362,0,22,0,3362,402587,86638,0,0
1038,3385,0,23,0,3385,405972,86615,0,0
1039,3401,0,16,0,3401,409373,86599,0,0
1040,3418,0,17,0,3418,412791,86582,0,0
1041,3438,0,20,0,3438,416229,86562,0,0
1042,3455,0,17,0,3455,419684,86545,0,0
1043,3469,0,14,0,3469,423153,86531,0,0
1044,3488,0,19,0,3488,426641,86512,0,0
1045,3507,0,19,0,3507,430148,86493,0,0
1046,3531,0,24,0,3531,433679,86469,0,0
1047,3547,0,16,0,3547,437226,86453,0,0
1048,3565,150886,18,1397,2168,289905,87832,0,0
1049,2185,0,17,0,2185,292090,87815,0,0
1050,2196,0,11,0,2196,294286,87804,0,0
1051,2210,0,14,0,2210,296496,87790,0,0
1052,2225,0,15,0,2225,298721,87775,0,0
1053,2239,0,14,0,2239,300960,87761,0,0
1054,2250,0,11,0,2250,303210,87750,0,0
1055,2257,0,7,0,2257,305467,87743,0,0
1056,2266,0,9,0,2266,307733,87734,0,0
1057,2274,0,8,0,2274,310007,87726,0,0
1058,2285,0,11,0,2285,312292,87715,0,0
1059,2302,0,17,0,2302,314594,87698,0,0
1060,2313,0,11,0,2313,316907,87687,0,0
1061,2318,0,5,0,2318,319225,87682,0,0
1062,2335,0,17,0,2335,321560,87665,0,0
1063,2352,0,17,0,2352,323912,87648,0,0
1064,2364,0,12,0,2364,326276,87636,0,0
1065,2376,0,12,0,2376,328652,87624,0,0
1066,2388,0,12,0,2388,331040,87612,0,0
1067,2398,0,10,0,2398,333438,87602,0,0
1068,2408,0,10,0,2408,335846,87592,0,0
1069,2419,0,11,0,2419,338265,87581,0,0
1070,2435,0,16,0,2435,340700,87565,0,0
1071,2445,0,10,0,2445,343145,87555,0,0
1072,2455,0,10,0,2455,345600,87545,0,0
1073,2460,0,5,0,2460,348060,87540,0,0
1074,2467,0,7,0,2467,350527,87533,0,0
1075,2479,0,12,0,2479,353006,87521,0,0
1076,2496,0,17,0,2496,355502,87504,0,0
1077,2506,0,10,0,2506,358008,87494,0,0
1078,2515,0,9,0,2515,360523,87485,0,0
1079,2524,0,9,0,2524,363047,87476,0,0
1080,2539,0,15,0,2539,365586,87461,0,0
1081,2550,0,11,0,2550,368136,87450,0,0
1082,2560,0,10,0,2560,370696,87440,0,0
1083,2579,0,19,0,2579,373275,87421,0,0
1084,2595,0,16,0,2595,375870,87405,0,0
1085,2610,0,15,0,2610,378480,87390,0,0
1086,2623,0,13,0,2623,381103,87377,0,0
1087,2633,0,10,0,2633,383736,87367,0,0
1088,2644,0,11,0,2644,386380,87356,0,0
1089,2652,0,8,0,2652,389032,87348,0,0
1090,2667,0,15,0,2667,391699,87333,0,0
1091,2683,0,16,0,2683,394382,87317,0,0
1092,2695,0,12,0,2695,397077,87305,0,0
1093,2707,0,12,0,2707,399784,87293,0,0
1094,2721,0,14,0,2721,402505,87279,0,0
1095,2728,0,7,0,2728,405233,87272,0,0
1096,2747,0,19,0,2747,407980,87253,0,0
1097,2755,0,8,0,2755,410735,87245,0,0
1098,2768,0,13,0,2768,413503,87232,0,0
1099,2788,0,20,0,2788,416291,87212,0,0
1100,2804,0,16,0,2804,419095,87196,0,0
1101,2813,0,9,0,2813,421908,87187,0,0
1102,2825,0,12,0,2825,424733,87175,0,0
1103,2834,0,9,0,2834,427567,87166,0,0
1104,2849,0,15,0,2849,430416,87151,0,0
1105,2860,0,11,0,2860,433276,87140,0,0
1106,2876,0,16,0,2876,436152,87124,0,0
1107,2889,0,13,0,2889,439041,87111,0,0
1108,2898,0,9,0,2898,441939,87102,0,0
1109,2923,0,25,0,2923,444862,87077,0,0
1110,2936,0,13,0,2936,447798,87064,0,0
1111,2950,0,14,0,2950,450748,87050,0,0
1112,2955,0,5,0,2955,453703,87045,0,0
1113,2964,0,9,0,2964,456667,87036,0,0
1114,2970,0,6,0,2970,459637,87030,0,0
1115,2984,0,14,0,2984,462621,87016,0,0
1116,2996,0,12,0,2996,465617,87004,0,0
1117,3012,0,16,0,3012,468629,86988,0,0
1118,3025,0,13,0,3025,471654,86975,0,0
1119,3040,0,15,0,3040,474694,86960,0,0
1120,3051,0,11,0,3051,477745,86949,0,0
1121,3059,0,8,0,3059,480804,86941,0,0
1122,3074,0,15,0,3074,483878,86926,0,0
1123,3089,0,15,0,3089,486967,86911,0,0
1124,3096,0,7,0,3096,490063,86904,0,0
1125,3111,0,15,0,3111,493174,86889,0,0
1126,3122,0,11,0,3122,496296,86878,0,0
1127,3135,0,13,0,3135,499431,86865,0,0
1128,3147,0,12,0,3147,502578,86853,0,0
1129,3161,0,14,0,3161,505739,86839,0,0
1130,3176,0,15,0,3176,508915,86824,0,0
1131,3188,0,12,0,3188,512103,86812,0,0
1132,3199,0,11,0,3199,515302,86801,0,0
1133,3211,0,12,0,3211,518513,86789,0,0
1134,3226,0,15,0,3226,521739,86774,0,0
1135,3238,0,12,0,3238,524977,86762,0,0
1136,3252,0,14,0,3252,528229,86748,0,0
1137,3265,0,13,0,3265,531494,86735,0,0
1138,3284,0,19,0,3284,534778,86716,0,0
1139,3294,0,10,0,3294,538072,86706,0,0
1140,3306,0,12,0,3306,541378,86694,0,0
1141,3318,0,12,0,3318,544696,86682,0,0
1142,3330,0,12,0,3330,548026,86670,0,0
1143,3343,0,13,0,3343,551369,86657,0,0
1144,3361,0,18,0,3361,554730,86639,0,0
1145,3382,0,21,0,3382,558112,86618,0,0
1146,3396,0,14,0,3396,561508,86604,0,0
1147,3407,0,11,0,3407,564915,86593,0,0
1148,3417,0,10,0,3417,568332,86583,0,0
1149,3440,0,23,0,3440,571772,86560,0,0
1150,3455,0,15,0,3455,575227,86545,0,0
1151,3473,578700,18,3473,0,0,90000,0,0
1152,0,0,0,0,0,0,90000,0,0
1153,0,0,0,0,0,0,90000,0,0
1154,0,0,0,0,0,0,90000,0,0
1155,0,0,0,0,0,0,90000,0,0
1156,0,0,0,0,0,0,90000,0,0
1157,0,0,0,0,0,0,90000,0,0
1158,0,0,0,0,0,0,90000,0,0
1159,0,0,0,0,0,0,90000,0,0
1160,0,0,0,0,0,0,90000,0,0
1161,0,0,0,0,0,0,90000,0,0
1162,0,0,0,0,0,0,90000,0,0
1163,0,0,0,0,0,0,90000,0,0
1164,0,0,0,0,0,0,90000,0,0
1165,0,0,0,0,0,0,90000,0,0
1166,0,0,0,0,0,0,90000,0,0
1167,0,0,0,0,0,0,90000,0,0
1168,0,0,0,0,0,0,90000,0,0
1169,0,0,0,0,0,0,90000,0,0
1170,0,0,0,0,0,0,90000,0,0
1171,0,0,0,0,0,0,90000,0,0
1172,1,0,1,0,1,1,89999,0,0
1173,1,0,0,0,1,2,89999,0,0
1174,2,0,1,0,2,4,89998,0,0
1175,2,0,0,0,2,6,89998,0,0
1176,2,0,0,0,2,8,89998,0,0
1177,2,0,0,0,2,10,89998,0,0
1178,3,0,1,0,3,13,89997,0,0
1179,4,0,1,0,4,17,89996,0,0
1180,6,0,2,0,6,23,89994,0,0
1181,6,0,0,0,6,29,89994,0,0
1182,7,0,1,0,7,36,89993,0,0
1183,7,0,0,0,7,43,89993,0,0
1184,7,0,0,0,7,50,89993,0,0
1185,8,0,1,0,8,58,89992,0,0
1186,9,0,1,0,9,67,89991,0,0
1187,10,0,1,0,10,77,89990,0,0
1188,11,0,1,0,11,88,89989,0,0
1189,12,0,1,0,12,100,89988,0,0
1190,13,0,1,0,13,113,89987,0,0
1191,15,0,2,0,15,128,89985,0,0
1192,17,0,2,0,17,145,89983,0,0
1193,18,0,1,0,18,163,89982,0,0
1194,20,0,2,0,20,183,89980,0,0
1195,26,0,6,0,26,209,89974,0,0
1196,28,0,2,0,28,237,89972,0,0
1197,29,0,1,0,29,266,89971,0,0
1198,30,0,1,0,30,296,89970,0,0
1199,33,0,3,0,33,329,89967,0,0
1200,35,0,2,0,35,364,89965,0,0
1201,40,0,5,0,40,404,89960,0,0
1202,44,0,4,0,44,448,89956,0,0
1203,49,0,5,0,49,497,89951,0,0
1204,55,0,6,0,55,552,89945,0,0
1205,62,0,7,0,62,614,89938,0,0
1206,69,0,7,0,69,683,89931,0,0
1207,72,0,3,0,72,755,89928,0,0
1208,78,0,6,0,78,833,89922,0,0
1209,82,0,4,0,82,915,89918,0,0
1210,87,0,5,0,87,1002,89913,0,0
1211,95,0,8,0,95,1097,89905,0,0
1212,107,0,12,0,107,1204,89893,0,0
1213,117,0,10,0,117,1321,89883,0,0
1214,129,0,12,0,129,1450,89871,0,0
1215,136,0,7,0,136,1586,89864,0,0
1216,144,0,8,0,144,1730,89856,0,0
1217,152,0,8,0,152,1882,89848,0,0
1218,161,0,9,0,161,2043,89839,0,0
1219,177,0,16,0,177,2220,89823,0,0
1220,191,0,14,0,191,2411,89809,0,0
1221,199,0,8,0,199,2610,89801,0,0
1222,209,0,10,0,209,2819,89791,0,0
1223,231,0,22,0,231,3050,89769,0,0
1224,251,0,20,0,251,3301,89749,0,0
1225,268,0,17,0,268,3569,89732,0,0
1226,289,0,21,0,289,3858,89711,0,0
1227,308,0,19,0,308,4166,89692,0,0
1228,327,0,19,0,327,4493,89673,0,0
1229,345,0,18,0,345,4838,89655,0,0
1230,363,0,18,0,363,5201,89637,0,0
1231,383,0,20,0,383,5584,89617,0,0
1232,402,0,19,0,402,5986,89598,0,0
1233,424,0,22,0,424,6410,89576,0,0
1234,450,0,26,0,450,6860,89550,0,0
1235,476,0,26,0,476,7336,89524,0,0
1236,504,0,28,0,504,7840,89496,0,0
1237,527,0,23,0,527,8367,89473,0,0
1238,566,0,39,0,566,8933,89434,0,0
1239,594,0,28,0,594,9527,89406,0,0
1240,625,0,31,0,625,10152,89375,0,0
1241,655,0,30,0,655,10807,89345,0,0
1242,691,0,36,0,691,11498,89309,0,0
1243,727,0,36,0,727,12225,89273,0,0
1244,754,0,27,0,754,12979,89246,0,0
1245,782,0,28,0,782,13761,89218,0,0
1246,822,0,40,0,822,14583,89178,0,0
1247,866,0,44,0,866,15449,89134,0,0
1248,902,0,36,0,902,16351,89098,0,0
1249,953,0,51,0,953,17304,89047,0,0
1250,999,0,46,0,999,18303,89001,0,0
1251,1054,0,55,0,1054,19357,88946,0,0
1252,1099,0,45,0,1099,20456,88901,0,0
1253,1144,0,45,0,1144,21600,88856,0,0
1254,1197,0,53,0,1197,22797,88803,0,0
1255,1252,0,55,0,1252,24049,88748,0,0
1256,1292,0,40,0,1292,25341,88708,0,0
1257,1344,0,52,0,1344,26685,88656,0,0
1258,1399,0,55,0,1399,28084,88601,0,0
1259,1459,0,60,0,1459,29543,88541,0,0
1260,1507,0,48,0,1507,31050,88493,0,0
1261,1552,0,45,0,1552,32602,88448,0,0
1262,1604,0,52,0,1604,34206,88396,0,0
1263,1670,0,66,0,1670,35876,88330,0,0
1264,1732,0,62,0,1732,37608,88268,0,0
1265,1795,0,63,0,1795,39403,88205,0,0
1266,1854,0,59,0,1854,41257,88146,0,0
1267,1937,0,83,0,1937,43194,88063,0,0
1268,2005,0,68,0,2005,45199,87995,0,0
1269,2082,0,77,0,2082,47281,87918,0,0
1270,2157,0,75,0,2157,49438,87843,0,0
1271,2231,0,74,0,2231,51669,87769,0,0
1272,2310,0,79,0,2310,53979,87690,0,0
1273,2397,0,87,0,2397,56376,87603,0,0
1274,2488,0,91,0,2488,58864,87512,0,0
1275,2567,0,79,0,2567,61431,87433,0,0
1276,2670,0,103,0,2670,64101,87330,0,0
1277,2743,0,73,0,2743,66844,87257,0,0
1278,2820,0,77,0,2820,69664,87180,0,0
1279,2910,0,90,0,2910,72574,87090,0,0
1280,2985,0,75,0,2985,75559,87015,0,0
1281,3078,3688,93,120,2958,74949,87042,0,0
1282,3057,0,99,0,3057,78006,86943,0,0
1283,3179,0,122,0,3179,81185,86821,0,0
1284,3276,0,97,0,3276,84461,86724,0,0
1285,3359,0,83,0,3359,87820,86641,0,0
1286,3465,0,106,0,3465,91285,86535,0,0
1287,3564,0,99,0,3564,94849,86436,0,0
1288,3664,0,100,0,3664,98513,86336,0,0
1289,3762,0,98,0,3762,102275,86238,0,0
1290,3871,0,109,0,3871,106146,86129,0,0
1291,3978,0,107,0,3978,110124,86022,0,0
1292,4091,0,113,0,4091,114215,85909,0,0
1293,4185,0,94,0,4185,118400,85815,0,0
1294,4286,0,101,0,4286,122686,85714,0,0
1295,4416,0,130,0,4416,127102,85584,0,0
1296,4513,0,97,0,4513,131615,85487,0,0
1297,4634,0,121,0,4634,136249,85366,0,0
1298,4755,0,121,0,4755,141004,85245,0,0
1299,4885,0,130,0,4885,145889,85115,0,0
1300,5021,0,136,0,5021,150910,84979,0,0
1301,5148,0,127,0,5148,156058,84852,0,0
1302,5276,0,128,0,5276,161334,84724,0,0
1303,5386,0,110,0,5386,166720,84614,0,0
1304,5537,0,151,0,5537,172257,84463,0,0
1305,5669,0,132,0,5669,177926,84331,0,0
1306,5795,0,126,0,5795,183721,84205,0,0
1307,5933,0,138,0,5933,189654,84067,0,0
1308,6066,0,133,0,6066,195720,83934,0,0
1309,6216,0,150,0,6216,201936,83784,0,0
1310,6370,0,154,0,6370,208306,83630,0,0
1311,6503,2053,133,65,6438,212756,83562,0,0
1312,6568,1826,130,72,6496,217498,83504,0,0
1313,6640,0,144,0,6640,224138,83360,0,0
1314,6790,0,150,0,6790,230928,83210,0,0
1315,6940,0,150,0,6940,237868,83060,0,0
1316,7085,0,145,0,7085,244953,82915,0,0
1317,7234,4162,149,115,7119,248025,82881,0,0
1318,7266,0,147,0,7266,255291,82734,0,0
1319,7420,0,154,0,7420,262711,82580,0,0
1320,7577,0,157,0,7577,270288,82423,0,0
1321,7741,0,164,0,7741,278029,82259,0,0
1322,7905,0,164,0,7905,285934,82095,0,0
1323,8081,0,176,0,8081,294015,81919,0,0
1324,8240,0,159,0,8240,302255,81760,0,0
1325,8409,0,169,0,8409,310664,81591,0,0
1326,8563,0,154,0,8563,319227,81437,0,0
1327,8735,0,172,0,8735,327962,81265,0,0
1328,8916,0,181,0,8916,336878,81084,0,0
1329,9093,0,177,0,9093,345971,80907,0,0
1330,9266,0,173,0,9266,355237,80734,0,0
1331,9458,0,192,0,9458,364695,80542,0,0
1332,9649,0,191,0,9649,374344,80351,0,0
1333,9817,0,168,0,9817,384161,80183,0,0
1334,9993,0,176,0,9993,394154,80007,0,0
1335,10184,0,191,0,10184,404338,79816,0,0
1336,10370,0,186,0,10370,414708,79630,0,0
1337,10589,0,219,0,10589,425297,79411,0,0
1338,10783,0,194,0,10783,436080,79217,0,0
1339,10958,0,175,0,10958,447038,79042,0,0
1340,11148,0,190,0,11148,458186,78852,0,0
1341,11340,0,192,0,11340,469526,78660,0,0
1342,11558,16165,218,302,11256,464919,78744,0,0
1343,11453,0,197,0,11453,476372,78547,0,0
1344,11670,31540,217,647,11023,456502,78977,0,0
1345,11228,0,205,0,11228,467730,78772,0,0
1346,11432,0,204,0,11432,479162,78568,0,0
1347,11635,0,203,0,11635,490797,78365,0,0
1348,11841,9081,206,214,11627,493557,78373,0,0
1349,11831,5696,204,135,11696,499692,78304,0,0
1350,11896,14257,200,266,11630,497331,78370,0,0
1351,11826,0,196,0,11826,509157,78174,0,0
1352,12006,31328,180,657,11349,489835,78651,0,0
1353,11552,27822,203,575,10977,473565,79023,0,0
1354,11179,0,202,0,11179,484744,78821,0,0
1355,11390,0,211,0,11390,496134,78610,0,0
1356,11552,0,162,0,11552,507686,78448,0,0
1357,11734,0,182,0,11734,519420,78266,0,0
1358,11899,16827,165,319,11580,514492,78420,0,0
1359,11768,0,188,0,11768,526260,78232,0,0
1360,11960,0,192,0,11960,538220,78040,0,0
1361,12166,0,206,0,12166,550386,77834,0,0
1362,12367,0,201,0,12367,562753,77633,0,0
1363,12564,0,197,0,12564,575317,77436,0,0
1364,12770,0,206,0,12770,588087,77230,0,0
1365,12984,10701,214,236,12748,590370,77252,0,0
1366,12950,0,202,0,12950,603320,77050,0,0
1367,13153,0,203,0,13153,616473,76847,0,0
1368,13374,0,221,0,13374,629847,76626,0,0
1369,13569,0,195,0,13569,643416,76431,0,0
1370,13790,0,221,0,13790,657206,76210,0,0
1371,13997,0,207,0,13997,671203,76003,0,0
1372,14205,0,208,0,14205,685408,75795,0,0
1373,14420,0,215,0,14420,699828,75580,0,0
1374,14662,39651,242,787,13875,674839,76125,0,0
1375,14126,0,251,0,14126,688965,75874,0,0
1376,14333,0,207,0,14333,703298,75667,0,0
1377,14554,0,221,0,14554,717852,75446,0,0
1378,14750,0,196,0,14750,732602,75250,0,0
1379,14977,0,227,0,14977,747579,75023,0,0
1380,15189,0,212,0,15189,762768,74811,0,0
1381,15407,22890,218,398,15009,755285,74991,0,0
1382,15224,0,215,0,15224,770509,74776,0,0
1383,15451,0,227,0,15451,785960,74549,0,0
1384,15675,0,224,0,15675,801635,74325,0,0
1385,15908,0,233,0,15908,817543,74092,0,0
1386,16157,20717,249,392,15765,812983,74235,0,0
1387,16002,0,237,0,16002,828985,73998,0,0
1388,16216,0,214,0,16216,845201,73784,0,0
1389,16453,0,237,0,16453,861654,73547,0,0
1390,16679,30356,226,573,16106,847977,73894,0,0
1391,16332,0,226,0,16332,864309,73668,0,0
1392,16557,0,225,0,16557,880866,73443,0,0
1393,16805,0,248,0,16805,897671,73195,0,0
1394,17039,0,234,0,17039,914710,72961,0,0
1395,17294,0,255,0,17294,932004,72706,0,0
1396,17541,0,247,0,17541,949545,72459,0,0
1397,17762,0,221,0,17762,967307,72238,0,0
1398,18001,0,239,0,18001,985308,71999,0,0
1399,18230,0,229,0,18230,1003538,71770,0,0
1400,18470,0,240,0,18470,1022008,71530,0,0
1401,18707,23137,237,380,18327,1017578,71673,0,0
1402,18573,0,246,0,18573,1036151,71427,0,0
1403,18828,0,255,0,18828,1054979,71172,0,0
1404,19072,19516,244,324,18748,1054535,71252,0,0
1405,19002,0,254,0,19002,1073537,70998,0,0
1406,19244,0,242,0,19244,1092781,70756,0,0
1407,19500,0,256,0,19500,1112281,70500,0,0
1408,19745,0,245,0,19745,1132026,70255,0,0
1409,19982,0,237,0,19982,1152008,70018,0,0
1410,20256,0,274,0,20256,1172264,69744,0,0
1411,20511,25660,255,412,20099,1167115,69901,0,0
1412,20335,47016,236,585,19750,1140434,70250,0,0
1413,20007,0,257,0,20007,1160441,69993,0,0
1414,20244,0,237,0,20244,1180685,69756,0,0
1415,20499,18080,255,335,20164,1183104,69836,0,0
1416,20399,0,235,0,20399,1203503,69601,0,0
1417,20613,0,214,0,20613,1224116,69387,0,0
1418,20873,0,260,0,20873,1244989,69127,0,0
1419,21148,0,275,0,21148,1266137,68852,0,0
1420,21382,0,234,0,21382,1287519,68618,0,0
1421,21646,0,264,0,21646,1309165,68354,0,0
1422,21931,0,285,0,21931,1331096,68069,0,0
1423,22194,0,263,0,22194,1353290,67806,0,0
1424,22434,0,240,0,22434,1375724,67566,0,0
1425,22686,52783,252,881,21805,1345627,68195,0,0
1426,22073,0,268,0,22073,1367700,67927,0,0
1427,22322,0,249,0,22322,1390022,67678,0,0
1428,22625,120407,303,1761,20864,1292240,69136,0,0
1429,21103,0,239,0,21103,1313343,68897,0,0
1430,21358,103553,255,1782,19576,1231148,70424,0,0
1431,19819,0,243,0,19819,1250967,70181,0,0
1432,20044,0,225,0,20044,1271011,69956,0,0
1433,20280,0,236,0,20280,1291291,69720,0,0
1434,20522,0,242,0,20522,1311813,69478,0,0
1435,20742,0,220,0,20742,1332555,69258,0,0
1436,20961,0,219,0,20961,1353516,69039,0,0
1437,21190,0,229,0,21190,1374706,68810,0,0
1438,21420,28786,230,437,20983,1367340,69017,0,0
1439,21226,0,243,0,21226,1388566,68774,0,0
1440,21457,127465,231,1715,19742,1282558,70258,0,0
1441,19949,25734,207,427,19522,1276773,70478,0,0
1442,19720,0,198,0,19720,1296493,70280,0,0
1443,19946,0,226,0,19946,1316439,70054,0,0
1444,20167,0,221,0,20167,1336606,69833,0,0
1445,20397,1858,230,69,20328,1355145,69672,0,0
1446,20565,0,237,0,20565,1375710,69435,0,0
1447,20764,0,199,0,20764,1396474,69236,0,0
1448,20985,0,221,0,20985,1417459,69015,0,0
1449,21219,2664,234,103,21116,1436014,68884,0,0
1450,21316,0,200,0,21316,1457330,68684,0,0
1451,21510,0,194,0,21510,1478840,68490,0,0
1452,21725,148618,215,2023,19702,1351947,70298,0,0
1453,19887,0,185,0,19887,1371834,70113,0,0
1454,20093,0,206,0,20093,1391927,69907,0,0
1455,20298,0,205,0,20298,1412225,69702,0,0
1456,20516,0,218,0,20516,1432741,69484,0,0
1457,20721,125762,205,1467,19254,1327700,70746,0,0
1458,19463,0,209,0,19463,1347163,70537,0,0
1459,19661,0,198,0,19661,1366824,70339,0,0
1460,19873,0,212,0,19873,1386697,70127,0,0
1461,20082,0,209,0,20082,1406779,69918,0,0
1462,20299,0,217,0,20299,1427078,69701,0,0
1463,20519,0,220,0,20519,1447597,69481,0,0
1464,20720,0,201,0,20720,1468317,69280,0,0
1465,20924,626720,204,7504,13420,862521,76580,0,0
1466,13572,0,152,0,13572,876093,76428,0,0
1467,13753,0,181,0,13753,889846,76247,0,0
1468,13906,0,153,0,13906,903752,76094,0,0
1469,14082,77561,176,1045,13037,840273,76963,0,0
1470,13196,0,159,0,13196,853469,76804,0,0
1471,13356,0,160,0,13356,866825,76644,0,0
1472,13470,0,114,0,13470,880295,76530,0,0
1473,13617,0,147,0,13617,893912,76383,0,0
1474,13791,0,174,0,13791,907703,76209,0,0
1475,13951,0,160,0,13951,921654,76049,0,0
1476,14104,0,153,0,14104,935758,75896,0,0
1477,14266,0,162,0,14266,950024,75734,0,0
1478,14434,0,168,0,14434,964458,75566,0,0
1479,14583,0,149,0,14583,979041,75417,0,0
1480,14734,0,151,0,14734,993775,75266,0,0
1481,14877,0,143,0,14877,1008652,75123,0,0
1482,15025,0,148,0,15025,1023677,74975,0,0
1483,15208,0,183,0,15208,1038885,74792,0,0
1484,15382,3290,174,101,15281,1050977,74719,0,0
1485,15462,0,181,0,15462,1066439,74538,0,0
1486,15634,0,172,0,15634,1082073,74366,0,0
1487,15816,0,182,0,15816,1097889,74184,0,0
1488,15983,0,167,0,15983,1113872,74017,0,0
1489,16126,0,143,0,16126,1129998,73874,0,0
1490,16308,0,182,0,16308,1146306,73692,0,0
1491,16488,0,180,0,16488,1162794,73512,0,0
1492,16679,0,191,0,16679,1179473,73321,0,0
1493,16869,0,190,0,16869,1196342,73131,0,0
1494,17060,0,191,0,17060,1213402,72940,0,0
1495,17224,0,164,0,17224,1230626,72776,0,0
1496,17390,143449,166,1925,15465,1104567,74535,0,0
1497,15648,0,183,0,15648,1120215,74352,0,0
1498,15783,0,135,0,15783,1135998,74217,0,0
1499,15949,0,166,0,15949,1151947,74051,0,0
1500,16130,0,181,0,16130,1168077,73870,0,0
1501,16288,0,158,0,16288,1184365,73712,0,0
1502,16474,0,186,0,16474,1200839,73526,0,0
1503,16641,0,167,0,16641,1217480,73359,0,0
1504,16807,0,166,0,16807,1234287,73193,0,0
1505,16971,0,164,0,16971,1251258,73029,0,0
1506,17135,246861,164,2827,14308,1021532,75692,0,0
1507,14455,0,147,0,14455,1035987,75545,0,0
1508,14594,0,139,0,14594,1050581,75406,0,0
1509,14751,0,157,0,14751,1065332,75249,0,0
1510,14934,0,183,0,14934,1080266,75066,0,0
1511,15104,0,170,0,15104,1095370,74896,0,0
1512,15264,34081,160,491,14773,1076553,75227,0,0
1513,14926,82241,153,1012,13914,1009238,76086,0,0
1514,14070,114338,156,1522,12548,908970,77452,0,0
1515,12688,0,140,0,12688,921658,77312,0,0
1516,12833,0,145,0,12833,934491,77167,0,0
1517,12981,0,148,0,12981,947472,77019,0,0
1518,13132,0,151,0,13132,960604,76868,0,0
1519,13257,0,125,0,13257,973861,76743,0,0
1520,13420,0,163,0,13420,987281,76580,0,0
1521,13571,0,151,0,13571,1000852,76429,0,0
1522,13717,0,146,0,13717,1014569,76283,0,0
1523,13885,0,168,0,13885,1028454,76115,0,0
1524,14053,0,168,0,14053,1042507,75947,0,0
1525,14222,0,169,0,14222,1056729,75778,0,0
1526,14377,0,155,0,14377,1071106,75623,0,0
1527,14530,0,153,0,14530,1085636,75470,0,0
1528,14703,0,173,0,14703,1100339,75297,0,0
1529,14871,0,168,0,14871,1115210,75129,0,0
1530,15051,0,180,0,15051,1130261,74949,0,0
1531,15207,0,156,0,15207,1145468,74793,0,0
1532,15393,0,186,0,15393,1160861,74607,0,0
1533,15579,0,186,0,15579,1176440,74421,0,0
1534,15731,0,152,0,15731,1192171,74269,0,0
1535,15904,0,173,0,15904,1208075,74096,0,0
1536,16058,0,154,0,16058,1224133,73942,0,0
1537,16222,147268,164,1675,14547,1093087,75453,0,0
1538,14731,3,184,1,14730,1107815,75270,0,0
1539,14881,101090,151,1116,13765,1021606,76235,0,0
1540,13922,0,157,0,13922,1035528,76078,0,0
1541,14092,3600,170,106,13986,1046020,76014,0,0
1542,14135,0,149,0,14135,1060155,75865,0,0
1543,14306,0,171,0,14306,1074461,75694,0,0
1544,14466,0,160,0,14466,1088927,75534,0,0
1545,14615,0,149,0,14615,1103542,75385,0,0
1546,14782,0,167,0,14782,1118324,75218,0,0
1547,14936,0,154,0,14936,1133260,75064,0,0
1548,15101,0,165,0,15101,1148361,74899,0,0
1549,15280,0,179,0,15280,1163641,74720,0,0
1550,15449,50443,169,580,14869,1128647,75131,0,0
1551,15026,0,157,0,15026,1143673,74974,0,0
1552,15193,0,167,0,15193,1158866,74807,0,0
1553,15371,0,178,0,15371,1174237,74629,0,0
1554,15548,0,177,0,15548,1189785,74452,0,0
1555,15723,0,175,0,15723,1205508,74277,0,0
1556,15900,0,177,0,15900,1221408,74100,0,0
1557,16033,0,133,0,16033,1237441,73967,0,0
1558,16203,216843,170,2331,13872,1036801,76128,0,0
1559,14032,0,160,0,14032,1050833,75968,0,0
1560,14183,0,151,0,14183,1065016,75817,0,0
1561,14361,0,178,0,14361,1079377,75639,0,0
1562,14502,0,141,0,14502,1093879,75498,0,0
1563,14676,0,174,0,14676,1108555,75324,0,0
1564,14845,0,169,0,14845,1123400,75155,0,0
1565,15045,0,200,0,15045,1138445,74955,0,0
1566,15229,0,184,0,15229,1153674,74771,0,0
1567,15402,0,173,0,15402,1169076,74598,0,0
1568,15585,0,183,0,15585,1184661,74415,0,0
1569,15790,0,205,0,15790,1200451,74210,0,0
1570,15978,0,188,0,15978,1216429,74022,0,0
1571,16159,0,181,0,16159,1232588,73841,0,0
1572,16339,0,180,0,16339,1248927,73661,0,0
1573,16543,0,204,0,16543,1265470,73457,0,0
1574,16719,0,176,0,16719,1282189,73281,0,0
1575,16903,0,184,0,16903,1299092,73097,0,0
1576,17103,0,200,0,17103,1316195,72897,0,0
1577,17300,0,197,0,17300,1333495,72700,0,0
1578,17470,84026,170,1019,16451,1266939,73549,0,0
1579,16655,0,204,0,16655,1283594,73345,0,0
1580,16859,0,204,0,16859,1300453,73141,0,0
1581,17033,0,174,0,17033,1317486,72967,0,0
1582,17206,12029,173,249,16957,1322663,73043,0,0
1583,17122,0,165,0,17122,1339785,72878,0,0
1584,17304,78409,182,787,16517,1278680,73483,0,0
1585,16695,0,178,0,16695,1295375,73305,0,0
1586,16867,0,172,0,16867,1312242,73133,0,0
1587,17054,0,187,0,17054,1329296,72946,0,0
1588,17248,0,194,0,17248,1346544,72752,0,0
1589,17415,72476,167,1097,16318,1291483,73682,0,0
1590,16513,0,195,0,16513,1307996,73487,0,0
1591,16699,0,186,0,16699,1324695,73301,0,0
1592,16883,0,184,0,16883,1341578,73117,0,0
1593,17080,0,197,0,17080,1358658,72920,0,0
1594,17254,24045,174,406,16848,1351867,73152,0,0
1595,17010,0,162,0,17010,1368877,72990,0,0
1596,17214,0,204,0,17214,1386091,72786,0,0
1597,17387,0,173,0,17387,1403478,72613,0,0
1598,17587,0,200,0,17587,1421065,72413,0,0
1599,17773,0,186,0,17773,1438838,72227,0,0
1600,17982,1,209,1,17981,1456819,72019,0,0
1601,18171,394528,190,3305,14866,1080462,75134,0,0
1602,15056,0,190,0,15056,1095518,74944,0,0
1603,15228,577102,172,5224,10004,533644,79996,0,0
1604,10138,0,134,0,10138,543782,79862,0,0
1605,10278,0,140,0,10278,554060,79722,0,0
1606,10422,0,144,0,10422,564482,79578,0,0
1607,10586,0,164,0,10586,575068,79414,0,0
1608,10765,0,179,0,10765,585833,79235,0,0
1609,10906,0,141,0,10906,596739,79094,0,0
1610,11078,0,172,0,11078,607817,78922,0,0
1611,11237,0,159,0,11237,619054,78763,0,0
1612,11405,0,168,0,11405,630459,78595,0,0
1613,11552,0,147,0,11552,642011,78448,0,0
1614,11709,0,157,0,11709,653720,78291,0,0
1615,11870,0,161,0,11870,665590,78130,0,0
1616,12062,0,192,0,12062,677652,77938,0,0
1617,12256,0,194,0,12256,689908,77744,0,0
1618,12438,2,182,1,12437,702344,77563,0,0
1619,12621,0,184,0,12621,714965,77379,0,0
1620,12789,0,168,0,12789,727754,77211,0,0
1621,12969,0,180,0,12969,740723,77031,0,0
1622,13148,0,179,0,13148,753871,76852,0,0
1623,13317,0,169,0,13317,767188,76683,0,0
1624,13517,1439,200,53,13464,779266,76536,0,0
1625,13668,0,204,0,13668,792934,76332,0,0
1626,13869,0,201,0,13869,806803,76131,0,0
1627,14045,0,176,0,14045,820848,75955,0,0
1628,14221,0,176,0,14221,835069,75779,0,0
1629,14430,0,209,0,14430,849499,75570,0,0
1630,14612,0,182,0,14612,864111,75388,0,0
1631,14825,0,213,0,14825,878936,75175,0,0
1632,15041,0,216,0,15041,893977,74959,0,0
1633,15221,0,180,0,15221,909198,74779,0,0
1634,15441,0,220,0,15441,924639,74559,0,0
1635,15623,0,182,0,15623,940262,74377,0,0
1636,15873,0,250,0,15873,956135,74127,0,0
1637,16084,1,211,1,16083,972218,73917,0,0
1638,16274,100757,191,1439,14835,887735,75165,0,0
1639,15022,0,187,0,15022,902757,74978,0,0
1640,15226,0,204,0,15226,917983,74774,0,0
1641,15418,0,192,0,15418,933401,74582,0,0
1642,15610,0,192,0,15610,949011,74390,0,0
1643,15816,58200,206,934,14882,906627,75118,0,0
1644,15085,0,203,0,15085,921712,74915,0,0
1645,15288,0,203,0,15288,937000,74712,0,0
1646,15483,0,195,0,15483,952483,74517,0,0
1647,15671,0,188,0,15671,968154,74329,0,0
1648,15867,10255,196,255,15612,973766,74388,0,0
1649,15833,0,221,0,15833,989599,74167,0,0
1650,16031,0,198,0,16031,1005630,73969,0,0
1651,16254,0,223,0,16254,1021884,73746,0,0
1652,16451,0,197,0,16451,1038335,73549,0,0
1653,16685,0,234,0,16685,1055020,73315,0,0
1654,16894,0,209,0,16894,1071914,73106,0,0
1655,17096,24684,202,491,16605,1064326,73395,0,0
1656,16803,0,198,0,16803,1081129,73197,0,0
1657,16988,0,185,0,16988,1098117,73012,0,0
1658,17208,0,220,0,17208,1115325,72792,0,0
1659,17396,0,188,0,17396,1132721,72604,0,0
1660,17593,124743,197,1662,15931,1025571,74069,0,0
1661,16144,0,213,0,16144,1041715,73856,0,0
1662,16355,0,211,0,16355,1058070,73645,0,0
1663,16544,12288,189,222,16322,1062326,73678,0,0
1664,16528,0,206,0,16528,1078854,73472,0,0
1665,16728,0,200,0,16728,1095582,73272,0,0
1666,16904,0,176,0,16904,1112486,73096,0,0
1667,17097,0,193,0,17097,1129583,72903,0,0
1668,17296,0,199,0,17296,1146879,72704,0,0
1669,17489,90276,193,1402,16087,1074092,73913,0,0
1670,16257,0,170,0,16257,1090349,73743,0,0
1671,16427,0,170,0,16427,1106776,73573,0,0
1672,16609,0,182,0,16609,1123385,73391,0,0
1673,16815,0,206,0,16815,1140200,73185,0,0
1674,17013,0,198,0,17013,1157213,72987,0,0
1675,17202,0,189,0,17202,1174415,72798,0,0
1676,17400,0,198,0,17400,1191815,72600,0,0
1677,17618,0,218,0,17618,1209433,72382,0,0
1678,17809,0,191,0,17809,1227242,72191,0,0
1679,18020,0,211,0,18020,1245262,71980,0,0
1680,18226,0,206,0,18226,1263488,71774,0,0
1681,18397,0,171,0,18397,1281885,71603,0,0
1682,18617,0,220,0,18617,1300502,71383,0,0
1683,18811,0,194,0,18811,1319313,71189,0,0
1684,18999,0,188,0,18999,1338312,71001,0,0
1685,19207,0,208,0,19207,1357519,70793,0,0
1686,19401,0,194,0,19401,1376920,70599,0,0
1687,19604,0,203,0,19604,1396524,70396,0,0
1688,19789,0,185,0,19789,1416313,70211,0,0
1689,20016,0,227,0,20016,1436329,69984,0,0
1690,20247,0,231,0,20247,1456576,69753,0,0
1691,20463,0,216,0,20463,1477039,69537,0,0
1692,20680,0,217,0,20680,1497719,69320,0,0
1693,20897,16126,217,335,20562,1502490,69438,0,0
1694,20754,0,192,0,20754,1523244,69246,0,0
1695,20947,0,193,0,20947,1544191,69053,0,0
1696,21160,262363,213,3166,17994,1302988,72006,0,0
1697,18181,0,187,0,18181,1321169,71819,0,0
1698,18356,0,175,0,18356,1339525,71644,0,0
1699,18528,0,172,0,18528,1358053,71472,0,0
1700,18736,6980,208,169,18567,1369809,71433,0,0
1701,18772,0,205,0,18772,1388581,71228,0,0
1702,18964,0,192,0,18964,1407545,71036,0,0
1703,19164,0,200,0,19164,1426709,70836,0,0
1704,19369,0,205,0,19369,1446078,70631,0,0
1705,19558,0,189,0,19558,1465636,70442,0,0
1706,19760,0,202,0,19760,1485396,70240,0,0
1707,19972,0,212,0,19972,1505368,70028,0,0
1708,20168,0,196,0,20168,1525536,69832,0,0
1709,20344,0,176,0,20344,1545880,69656,0,0
1710,20567,0,223,0,20567,1566447,69433,0,0
1711,20736,0,169,0,20736,1587183,69264,0,0
1712,20919,0,183,0,20919,1608102,69081,0,0
1713,21131,0,212,0,21131,1629233,68869,0,0
1714,21342,0,211,0,21342,1650575,68658,0,0
1715,21560,0,218,0,21560,1672135,68440,0,0
1716,21787,0,227,0,21787,1693922,68213,0,0
1717,21976,0,189,0,21976,1715898,68024,0,0
1718,22189,0,213,0,22189,1738087,67811,0,0
1719,22411,0,222,0,22411,1760498,67589,0,0
1720,22609,87567,198,1080,21529,1695540,68471,0,0
1721,21725,3761,196,105,21620,1713504,68380,0,0
1722,21814,0,194,0,21814,1735318,68186,0,0
1723,22020,0,206,0,22020,1757338,67980,0,0
1724,22215,5867,195,152,22063,1773686,67937,0,0
1725,22256,0,193,0,22256,1795942,67744,0,0
1726,22462,99014,206,720,21742,1719390,68258,0,0
1727,21955,373116,213,3069,18886,1368229,71114,0,0
1728,19077,0,191,0,19077,1387306,70923,0,0
1729,19260,0,183,0,19260,1406566,70740,0,0
1730,19472,0,212,0,19472,1426038,70528,0,0
1731,19672,0,200,0,19672,1445710,70328,0,0
1732,19903,0,231,0,19903,1465613,70097,0,0
1733,20090,169765,187,2413,17677,1315938,72323,0,0
1734,17850,105388,173,1621,16229,1228400,73771,0,0
1735,16399,0,170,0,16399,1244799,73601,0,0
1736,16582,0,183,0,16582,1261381,73418,0,0
1737,16764,0,182,0,16764,1278145,73236,0,0
1738,16921,0,157,0,16921,1295066,73079,0,0
1739,17107,0,186,0,17107,1312173,72893,0,0
1740,17274,0,167,0,17274,1329447,72726,0,0
1741,17439,0,165,0,17439,1346886,72561,0,0
1742,17635,0,196,0,17635,1364521,72365,0,0
1743,17794,4282,159,116,17678,1378033,72322,0,0
1744,17846,0,168,0,17846,1395879,72154,0,0
1745,18015,0,169,0,18015,1413894,71985,0,0
1746,18169,0,154,0,18169,1432063,71831,0,0
1747,18347,0,178,0,18347,1450410,71653,0,0
1748,18516,0,169,0,18516,1468926,71484,0,0
1749,18683,0,167,0,18683,1487609,71317,0,0
1750,18872,0,189,0,18872,1506481,71128,0,0
1751,19041,0,169,0,19041,1525522,70959,0,0
1752,19206,0,165,0,19206,1544728,70794,0,0
1753,19395,0,189,0,19395,1564123,70605,0,0
1754,19593,0,198,0,19593,1583716,70407,0,0
1755,19770,0,177,0,19770,1603486,70230,0,0
1756,19950,0,180,0,19950,1623436,70050,0,0
1757,20130,134388,180,1361,18769,1509178,71231,0,0
1758,18966,0,197,0,18966,1528144,71034,0,0
1759,19160,0,194,0,19160,1547304,70840,0,0
1760,19341,0,181,0,19341,1566645,70659,0,0
1761,19529,0,188,0,19529,1586174,70471,0,0
1762,19701,6869,172,145,19556,1599006,70444,0,0
1763,19754,0,198,0,19754,1618760,70246,0,0
1764,19957,0,203,0,19957,1638717,70043,0,0
1765,20165,713534,208,6782,13383,945348,76617,0,0
1766,13533,0,150,0,13533,958881,76467,0,0
1767,13676,0,143,0,13676,972557,76324,0,0
1768,13836,0,160,0,13836,986393,76164,0,0
1769,14000,0,164,0,14000,1000393,76000,0,0
1770,14149,0,149,0,14149,1014542,75851,0,0
1771,14313,0,164,0,14313,1028855,75687,0,0
1772,14487,0,174,0,14487,1043342,75513,0,0
1773,14656,0,169,0,14656,1057998,75344,0,0
1774,14828,0,172,0,14828,1072826,75172,0,0
1775,15003,0,175,0,15003,1087829,74997,0,0
1776,15164,0,161,0,15164,1102993,74836,0,0
1777,15347,0,183,0,15347,1118340,74653,0,0
1778,15539,0,192,0,15539,1133879,74461,0,0
1779,15727,0,188,0,15727,1149606,74273,0,0
1780,15888,0,161,0,15888,1165494,74112,0,0
1781,16031,0,143,0,16031,1181525,73969,0,0
1782,16223,0,192,0,16223,1197748,73777,0,0
1783,16392,0,169,0,16392,1214140,73608,0,0
1784,16568,0,176,0,16568,1230708,73432,0,0
1785,16772,42670,204,685,16087,1204810,73913,0,0
1786,16274,0,187,0,16274,1221084,73726,0,0
1787,16450,245497,176,2340,14110,992037,75890,0,0
1788,14284,0,174,0,14284,1006321,75716,0,0
1789,14457,0,173,0,14457,1020778,75543,0,0
1790,14641,0,184,0,14641,1035419,75359,0,0
1791,14832,0,191,0,14832,1050251,75168,0,0
1792,15039,0,207,0,15039,1065290,74961,0,0
1793,15200,0,161,0,15200,1080490,74800,0,0
1794,15366,0,166,0,15366,1095856,74634,0,0
1795,15546,0,180,0,15546,1111402,74454,0,0
1796,15726,0,180,0,15726,1127128,74274,0,0
1797,15921,0,195,0,15921,1143049,74079,0,0
1798,16125,19380,204,329,15796,1139794,74204,0,0
1799,15986,0,190,0,15986,1155780,74014,0,0
1800,16187,0,201,0,16187,1171967,73813,0,0
1801,16385,0,198,0,16385,1188352,73615,0,0
1802,16584,0,199,0,16584,1204936,73416,0,0
1803,16787,0,203,0,16787,1221723,73213,0,0
1804,16954,0,167,0,16954,1238677,73046,0,0
1805,17150,0,196,0,17150,1255827,72850,0,0
1806,17354,0,204,0,17354,1273181,72646,0,0
1807,17544,0,190,0,17544,1290725,72456,0,0
1808,17753,19799,209,449,17304,1288679,72696,0,0
1809,17515,0,211,0,17515,1306194,72485,0,0
1810,17739,0,224,0,17739,1323933,72261,0,0
1811,17893,227482,154,2303,15590,1114344,74410,0,0
1812,15761,0,171,0,15761,1130105,74239,0,0
1813,15977,0,216,0,15977,1146082,74023,0,0
1814,16174,4646,197,157,16017,1157610,73983,0,0
1815,16207,0,190,0,16207,1173817,73793,0,0
1816,16420,51141,213,915,15505,1139096,74495,0,0
1817,15694,0,189,0,15694,1154790,74306,0,0
1818,15893,0,199,0,15893,1170683,74107,0,0
1819,16064,0,171,0,16064,1186747,73936,0,0
1820,16251,0,187,0,16251,1202998,73749,0,0
1821,16455,0,204,0,16455,1219453,73545,0,0
1822,16649,0,194,0,16649,1236102,73351,0,0
1823,16848,210070,199,2292,14556,1042880,75444,0,0
1824,14740,0,184,0,14740,1057620,75260,0,0
1825,14935,0,195,0,14935,1072555,75065,0,0
1826,15109,144892,174,2399,12710,942772,77290,0,0
1827,12854,0,144,0,12854,955626,77146,0,0
1828,13029,0,175,0,13029,968655,76971,0,0
1829,13175,0,146,0,13175,981830,76825,0,0
1830,13316,0,141,0,13316,995146,76684,0,0
1831,13482,0,166,0,13482,1008628,76518,0,0
1832,13653,0,171,0,13653,1022281,76347,0,0
1833,13805,0,152,0,13805,1036086,76195,0,0
1834,13987,0,182,0,13987,1050073,76013,0,0
1835,14136,0,149,0,14136,1064209,75864,0,0
1836,14305,0,169,0,14305,1078514,75695,0,0
1837,14490,335984,185,4358,10132,757020,79868,0,0
1838,10260,0,128,0,10260,767280,79740,0,0
1839,10410,0,150,0,10410,777690,79590,0,0
1840,10531,57755,121,987,9544,730466,80456,0,0
1841,9690,0,146,0,9690,740156,80310,0,0
1842,9825,0,135,0,9825,749981,80175,0,0
1843,9948,0,123,0,9948,759929,80052,0,0
1844,10077,0,129,0,10077,770006,79923,0,0
1845,10210,0,133,0,10210,780216,79790,0,0
1846,10347,0,137,0,10347,790563,79653,0,0
1847,10505,0,158,0,10505,801068,79495,0,0
1848,10662,0,157,0,10662,811730,79338,0,0
1849,10805,0,143,0,10805,822535,79195,0,0
1850,10959,0,154,0,10959,833494,79041,0,0
1851,11121,0,162,0,11121,844615,78879,0,0
1852,11267,0,146,0,11267,855882,78733,0,0
1853,11433,0,166,0,11433,867315,78567,0,0
1854,11586,0,153,0,11586,878901,78414,0,0
1855,11763,0,177,0,11763,890664,78237,0,0
1856,11913,0,150,0,11913,902577,78087,0,0
1857,12069,0,156,0,12069,914646,77931,0,0
1858,12244,0,175,0,12244,926890,77756,0,0
1859,12405,0,161,0,12405,939295,77595,0,0
1860,12603,0,198,0,12603,951898,77397,0,0
1861,12754,0,151,0,12754,964652,77246,0,0
1862,12928,0,174,0,12928,977580,77072,0,0
1863,13104,0,176,0,13104,990684,76896,0,0
1864,13310,0,206,0,13310,1003994,76690,0,0
1865,13509,0,199,0,13509,1017503,76491,0,0
1866,13660,0,151,0,13660,1031163,76340,0,0
1867,13836,0,176,0,13836,1044999,76164,0,0
1868,14033,563749,197,4030,10003,495283,79997,0,0
1869,10168,0,165,0,10168,505451,79832,0,0
1870,10332,0,164,0,10332,515783,79668,0,0
1871,10516,0,184,0,10516,526299,79484,0,0
1872,10702,0,186,0,10702,537001,79298,0,0
1873,10862,0,160,0,10862,547863,79138,0,0
1874,11035,0,173,0,11035,558898,78965,0,0
1875,11202,0,167,0,11202,570100,78798,0,0
1876,11419,0,217,0,11419,581519,78581,0,0
1877,11643,0,224,0,11643,593162,78357,0,0
1878,11839,0,196,0,11839,605001,78161,0,0
1879,12042,6,203,1,12041,617037,77959,0,0
1880,12232,0,191,0,12232,629269,77768,0,0
1881,12429,0,197,0,12429,641698,77571,0,0
1882,12619,0,190,0,12619,654317,77381,0,0
1883,12819,0,200,0,12819,667136,77181,0,0
1884,13028,0,209,0,13028,680164,76972,0,0
1885,13246,0,218,0,13246,693410,76754,0,0
1886,13471,0,225,0,13471,706881,76529,0,0
1887,13682,0,211,0,13682,720563,76318,0,0
1888,13861,0,179,0,13861,734424,76139,0,0
1889,14064,0,203,0,14064,748488,75936,0,0
1890,14282,0,218,0,14282,762770,75718,0,0
1891,14490,0,208,0,14490,777260,75510,0,0
1892,14713,0,223,0,14713,791973,75287,0,0
1893,14912,17913,199,395,14517,788972,75483,0,0
1894,14721,0,204,0,14721,803693,75279,0,0
1895,14980,0,259,0,14980,818673,75020,0,0
1896,15231,0,251,0,15231,833904,74769,0,0
1897,15470,0,239,0,15470,849374,74530,0,0
1898,15692,0,222,0,15692,865066,74308,0,0
1899,15901,0,209,0,15901,880967,74099,0,0
1900,16133,18837,232,354,15779,878263,74221,0,0
1901,16005,69147,226,1171,14834,825121,75166,0,0
1902,15048,0,214,0,15048,840169,74952,0,0
1903,15275,0,227,0,15275,855444,74725,0,0
1904,15503,0,228,0,15503,870947,74497,0,0
1905,15736,0,233,0,15736,886683,74264,0,0
1906,15965,0,229,0,15965,902648,74035,0,0
1907,16180,0,215,0,16180,918828,73820,0,0
1908,16391,24306,211,501,15890,910913,74110,0,0
1909,16152,0,262,0,16152,927065,73848,0,0
1910,16377,0,225,0,16377,943442,73623,0,0
1911,16588,0,211,0,16588,960030,73412,0,0
1912,16799,2590,211,94,16705,974239,73295,0,0
1913,16939,0,234,0,16939,991178,73061,0,0
1914,17200,0,261,0,17200,1008378,72800,0,0
1915,17445,0,245,0,17445,1025823,72555,0,0
1916,17693,0,248,0,17693,1043516,72307,0,0
1917,17930,0,237,0,17930,1061446,72070,0,0
1918,18155,0,225,0,18155,1079601,71845,0,0
1919,18384,306941,229,3644,14740,791044,75260,0,0
1920,14952,0,212,0,14952,805996,75048,0,0
1921,15159,0,207,0,15159,821155,74841,0,0
1922,15388,0,229,0,15388,836543,74612,0,0
1923,15601,0,213,0,15601,852144,74399,0,0
1924,15852,0,251,0,15852,867996,74148,0,0
1925,16068,0,216,0,16068,884064,73932,0,0
1926,16329,0,261,0,16329,900393,73671,0,0
1927,16555,0,226,0,16555,916948,73445,0,0
1928,16778,0,223,0,16778,933726,73222,0,0
1929,16986,0,208,0,16986,950712,73014,0,0
1930,17202,0,216,0,17202,967914,72798,0,0
1931,17449,0,247,0,17449,985363,72551,0,0
1932,17701,25920,252,439,17262,977144,72738,0,0
1933,17493,10631,231,260,17233,984006,72767,0,0
1934,17460,0,227,0,17460,1001466,72540,0,0
1935,17710,0,250,0,17710,1019176,72290,0,0
1936,17945,0,235,0,17945,1037121,72055,0,0
1937,18206,0,261,0,18206,1055327,71794,0,0
1938,18444,0,238,0,18444,1073771,71556,0,0
1939,18675,0,231,0,18675,1092446,71325,0,0
1940,18927,0,252,0,18927,1111373,71073,0,0
1941,19164,0,237,0,19164,1130537,70836,0,0
1942,19427,0,263,0,19427,1149964,70573,0,0
1943,19678,0,251,0,19678,1169642,70322,0,0
1944,19916,0,238,0,19916,1189558,70084,0,0
1945,20160,0,244,0,20160,1209718,69840,0,0
1946,20429,0,269,0,20429,1230147,69571,0,0
1947,20691,0,262,0,20691,1250838,69309,0,0
1948,20968,32395,277,637,20331,1239411,69669,0,0
1949,20593,0,262,0,20593,1260004,69407,0,0
1950,20850,2883,257,100,20750,1277971,69250,0,0
1951,21008,0,258,0,21008,1298979,68992,0,0
1952,21277,504,269,27,21250,1319752,68750,0,0
1953,21489,0,239,0,21489,1341241,68511,0,0
1954,21721,19810,232,394,21327,1343152,68673,0,0
1955,21620,0,293,0,21620,1364772,68380,0,0
1956,21886,0,266,0,21886,1386658,68114,0,0
1957,22154,0,268,0,22154,1408812,67846,0,0
1958,22398,363234,244,4869,17529,1067976,72471,0,0
1959,17749,0,220,0,17749,1085725,72251,0,0
1960,17961,95221,212,1207,16754,1008465,73246,0,0
1961,16970,0,216,0,16970,1025435,73030,0,0
1962,17177,0,207,0,17177,1042612,72823,0,0
1963,17383,0,206,0,17383,1059995,72617,0,0
1964,17590,0,207,0,17590,1077585,72410,0,0
1965,17792,0,202,0,17792,1095377,72208,0,0
1966,18010,0,218,0,18010,1113387,71990,0,0
1967,18240,0,230,0,18240,1131627,71760,0,0
1968,18470,0,230,0,18470,1150097,71530,0,0
1969,18670,0,200,0,18670,1168767,71330,0,0
1970,18902,0,232,0,18902,1187669,71098,0,0
1971,19121,122167,219,1583,17538,1084623,72462,0,0
1972,17751,0,213,0,17751,1102374,72249,0,0
1973,17955,0,204,0,17955,1120329,72045,0,0
1974,18196,0,241,0,18196,1138525,71804,0,0
1975,18428,0,232,0,18428,1156953,71572,0,0
1976,18661,0,233,0,18661,1175614,71339,0,0
1977,18891,0,230,0,18891,1194505,71109,0,0
1978,19096,0,205,0,19096,1213601,70904,0,0
1979,19323,0,227,0,19323,1232924,70677,0,0
1980,19556,0,233,0,19556,1252480,70444,0,0
1981,19771,0,215,0,19771,1272251,70229,0,0
1982,20014,0,243,0,20014,1292265,69986,0,0
1983,20240,0,226,0,20240,1312505,69760,0,0
1984,20467,0,227,0,20467,1332972,69533,0,0
1985,20712,0,245,0,20712,1353684,69288,0,0
1986,20911,0,199,0,20911,1374595,69089,0,0
1987,21140,0,229,0,21140,1395735,68860,0,0
1988,21362,11290,222,234,21128,1405807,68872,0,0
1989,21364,0,236,0,21364,1427171,68636,0,0
1990,21603,0,239,0,21603,1448774,68397,0,0
1991,21859,0,256,0,21859,1470633,68141,0,0
1992,22106,0,247,0,22106,1492739,67894,0,0
1993,22347,0,241,0,22347,1515086,67653,0,0
1994,22569,0,222,0,22569,1537655,67431,0,0
1995,22784,0,215,0,22784,1560439,67216,0,0
1996,23011,0,227,0,23011,1583450,66989,0,0
1997,23264,49372,253,760,22504,1557342,67496,0,0
1998,22756,0,252,0,22756,1580098,67244,0,0
1999,23011,0,255,0,23011,1603109,66989,0,0
2000,23265,0,254,0,23265,1626374,66735,0,0
2001,23499,0,234,0,23499,1649873,66501,0,0
2002,23741,0,242,0,23741,1673614,66259,0,0
2003,23963,612643,222,6714,17249,1084934,72751,0,0
2004,17451,159142,202,2061,15390,943243,74610,0,0
2005,15590,0,200,0,15590,958833,74410,0,0
2006,15759,0,169,0,15759,974592,74241,0,0
2007,15956,0,197,0,15956,990548,74044,0,0
2008,16129,0,173,0,16129,1006677,73871,0,0
2009,16308,0,179,0,16308,1022985,73692,0,0
2010,16515,0,207,0,16515,1039500,73485,0,0
2011,16695,0,180,0,16695,1056195,73305,0,0
2012,16875,0,180,0,16875,1073070,73125,0,0
2013,17074,0,199,0,17074,1090144,72926,0,0
2014,17294,0,220,0,17294,1107438,72706,0,0
2015,17491,0,197,0,17491,1124929,72509,0,0
2016,17680,0,189,0,17680,1142609,72320,0,0
2017,17888,0,208,0,17888,1160497,72112,0,0
2018,18082,0,194,0,18082,1178579,71918,0,0
2019,18269,0,187,0,18269,1196848,71731,0,0
2020,18472,0,203,0,18472,1215320,71528,0,0
2021,18674,0,202,0,18674,1233994,71326,0,0
2022,18894,0,220,0,18894,1252888,71106,0,0
2023,19093,0,199,0,19093,1271981,70907,0,0
2024,19307,0,214,0,19307,1291288,70693,0,0
2025,19514,0,207,0,19514,1310802,70486,0,0
2026,19729,0,215,0,19729,1330531,70271,0,0
2027,19939,416883,210,4677,15262,933587,74738,0,0
2028,15456,0,194,0,15456,949043,74544,0,0
2029,15622,61702,166,1024,14598,902963,75402,0,0
2030,14782,0,184,0,14782,917745,75218,0,0
2031,14952,0,170,0,14952,932697,75048,0,0
2032,15114,0,162,0,15114,947811,74886,0,0
2033,15291,0,177,0,15291,963102,74709,0,0
2034,15472,0,181,0,15472,978574,74528,0,0
2035,15675,0,203,0,15675,994249,74325,0,0
2036,15843,0,168,0,15843,1010092,74157,0,0
2037,16037,0,194,0,16037,1026129,73963,0,0
2038,16216,0,179,0,16216,1042345,73784,0,0
2039,16391,0,175,0,16391,1058736,73609,0,0
2040,16558,0,167,0,16558,1075294,73442,0,0
2041,16741,0,183,0,16741,1092035,73259,0,0
2042,16923,0,182,0,16923,1108958,73077,0,0
2043,17116,0,193,0,17116,1126074,72884,0,0
2044,17307,0,191,0,17307,1143381,72693,0,0
2045,17510,0,203,0,17510,1160891,72490,0,0
2046,17709,0,199,0,17709,1178600,72291,0,0
2047,17931,197746,222,2169,15762,998785,74238,0,0
2048,15952,0,190,0,15952,1014737,74048,0,0
2049,16148,0,196,0,16148,1030885,73852,0,0
2050,16332,0,184,0,16332,1047217,73668,0,0
2051,16501,0,169,0,16501,1063718,73499,0,0
2052,16685,0,184,0,16685,1080403,73315,0,0
2053,16901,0,216,0,16901,1097304,73099,0,0
2054,17106,0,205,0,17106,1114410,72894,0,0
2055,17297,104416,191,1547,15750,1027291,74250,0,0
2056,15916,120316,166,1885,14031,922891,75969,0,0
2057,14205,0,174,0,14205,937096,75795,0,0
2058,14389,0,184,0,14389,951485,75611,0,0
2059,14560,0,171,0,14560,966045,75440,0,0
2060,14733,0,173,0,14733,980778,75267,0,0
2061,14897,0,164,0,14897,995675,75103,0,0
2062,15063,135244,166,1585,13478,875494,76522,0,0
2063,13620,0,142,0,13620,889114,76380,0,0
2064,13802,100582,182,1363,12439,802334,77561,0,0
2065,12575,0,136,0,12575,814909,77425,0,0
2066,12747,0,172,0,12747,827656,77253,0,0
2067,12897,0,150,0,12897,840553,77103,0,0
2068,13045,0,148,0,13045,853598,76955,0,0
2069,13216,0,171,0,13216,866814,76784,0,0
2070,13405,69610,189,883,12522,810609,77478,0,0
2071,12689,0,167,0,12689,823298,77311,0,0
2072,12843,0,154,0,12843,836141,77157,0,0
2073,12997,0,154,0,12997,849138,77003,0,0
2074,13159,0,162,0,13159,862297,76841,0,0
2075,13331,0,172,0,13331,875628,76669,0,0
2076,13499,0,168,0,13499,889127,76501,0,0
2077,13697,0,198,0,13697,902824,76303,0,0
2078,13851,0,154,0,13851,916675,76149,0,0
2079,14002,0,151,0,14002,930677,75998,0,0
2080,14197,0,195,0,14197,944874,75803,0,0
2081,14375,3943,178,115,14260,955306,75740,0,0
2082,14428,256177,168,2412,12016,713557,77984,0,0
2083,12169,0,153,0,12169,725726,77831,0,0
2084,12316,74979,147,1132,11184,663063,78816,0,0
2085,11338,0,154,0,11338,674401,78662,0,0
2086,11476,64369,138,1036,10440,621508,79560,0,0
2087,10608,1104,168,44,10564,631012,79436,0,0
2088,10726,0,162,0,10726,641738,79274,0,0
2089,10879,105235,153,1715,9164,547382,80836,0,0
2090,9303,136235,139,1720,7583,420450,82417,0,0
2091,7705,0,122,0,7705,428155,82295,0,0
2092,7814,0,109,0,7814,435969,82186,0,0
2093,7936,0,122,0,7936,443905,82064,0,0
2094,8037,0,101,0,8037,451942,81963,0,0
2095,8150,0,113,0,8150,460092,81850,0,0
2096,8292,0,142,0,8292,468384,81708,0,0
2097,8410,0,118,0,8410,476794,81590,0,0
2098,8523,0,113,0,8523,485317,81477,0,0
2099,8671,0,148,0,8671,493988,81329,0,0
2100,8797,239368,126,3005,5792,263417,84208,0,0
2101,5903,0,111,0,5903,269320,84097,0,0
2102,6015,0,112,0,6015,275335,83985,0,0
2103,6113,0,98,0,6113,281448,83887,0,0
2104,6225,0,112,0,6225,287673,83775,0,0
2105,6346,0,121,0,6346,294019,83654,0,0
2106,6465,0,119,0,6465,300484,83535,0,0
2107,6584,0,119,0,6584,307068,83416,0,0
2108,6715,0,131,0,6715,313783,83285,0,0
2109,6846,0,131,0,6846,320629,83154,0,0
2110,6983,0,137,0,6983,327612,83017,0,0
2111,7111,0,128,0,7111,334723,82889,0,0
2112,7235,0,124,0,7235,341958,82765,0,0
2113,7363,0,128,0,7363,349321,82637,0,0
2114,7517,0,154,0,7517,356838,82483,0,0
2115,7662,0,145,0,7662,364500,82338,0,0
2116,7814,0,152,0,7814,372314,82186,0,0
2117,7947,36450,133,443,7504,343811,82496,0,0
2118,7623,0,119,0,7623,351434,82377,0,0
2119,7768,0,145,0,7768,359202,82232,0,0
2120,7917,0,149,0,7917,367119,82083,0,0
2121,8049,0,132,0,8049,375168,81951,0,0
2122,8197,84524,148,1176,7021,298841,82979,0,0
2123,7151,0,130,0,7151,305992,82849,0,0
2124,7288,0,137,0,7288,313280,82712,0,0
2125,7439,0,151,0,7439,320719,82561,0,0
2126,7565,0,126,0,7565,328284,82435,0,0
2127,7722,0,157,0,7722,336006,82278,0,0
2128,7871,0,149,0,7871,343877,82129,0,0
2129,8027,0,156,0,8027,351904,81973,0,0
2130,8172,0,145,0,8172,360076,81828,0,0
2131,8294,0,122,0,8294,368370,81706,0,0
2132,8442,0,148,0,8442,376812,81558,0,0
2133,8598,0,156,0,8598,385410,81402,0,0
2134,8757,0,159,0,8757,394167,81243,0,0
2135,8934,0,177,0,8934,403101,81066,0,0
2136,9085,0,151,0,9085,412186,80915,0,0
2137,9272,0,187,0,9272,421458,80728,0,0
2138,9426,0,154,0,9426,430884,80574,0,0
2139,9587,0,161,0,9587,440471,80413,0,0
2140,9762,0,175,0,9762,450233,80238,0,0
2141,9939,0,177,0,9939,460172,80061,0,0
2142,10089,0,150,0,10089,470261,79911,0,0
2143,10272,0,183,0,10272,480533,79728,0,0
2144,10470,57357,198,1007,9463,433646,80537,0,0
2145,9623,0,160,0,9623,443269,80377,0,0
2146,9802,0,179,0,9802,453071,80198,0,0
2147,9981,0,179,0,9981,463052,80019,0,0
2148,10145,0,164,0,10145,473197,79855,0,0
2149,10316,0,171,0,10316,483513,79684,0,0
2150,10477,0,161,0,10477,493990,79523,0,0
2151,10645,0,168,0,10645,504635,79355,0,0
2152,10858,58959,213,1181,9677,456534,80323,0,0
2153,9842,0,165,0,9842,466376,80158,0,0
2154,10020,0,178,0,10020,476396,79980,0,0
2155,10184,0,164,0,10184,486580,79816,0,0
2156,10363,0,179,0,10363,496943,79637,0,0
2157,10557,0,194,0,10557,507500,79443,0,0
2158,10737,0,180,0,10737,518237,79263,0,0
2159,10946,0,209,0,10946,529183,79054,0,0
2160,11137,0,191,0,11137,540320,78863,0,0
2161,11323,0,186,0,11323,551643,78677,0,0
2162,11491,0,168,0,11491,563134,78509,0,0
2163,11675,0,184,0,11675,574809,78325,0,0
2164,11849,0,174,0,11849,586658,78151,0,0
2165,12045,0,196,0,12045,598703,77955,0,0
2166,12262,0,217,0,12262,610965,77738,0,0
2167,12486,0,224,0,12486,623451,77514,0,0
2168,12703,0,217,0,12703,636154,77297,0,0
2169,12939,0,236,0,12939,649093,77061,0,0
2170,13145,0,206,0,13145,662238,76855,0,0
2171,13364,0,219,0,13364,675602,76636,0,0
2172,13558,0,194,0,13558,689160,76442,0,0
2173,13793,30481,235,579,13214,672472,76786,0,0
2174,13445,25940,231,434,13011,659977,76989,0,0
2175,13254,0,243,0,13254,673231,76746,0,0
2176,13461,0,207,0,13461,686692,76539,0,0
2177,13671,0,210,0,13671,700363,76329,0,0
2178,13899,0,228,0,13899,714262,76101,0,0
2179,14119,0,220,0,14119,728381,75881,0,0
2180,14355,0,236,0,14355,742736,75645,0,0
2181,14607,3292,252,103,14504,754051,75496,0,0
2182,14747,0,243,0,14747,768798,75253,0,0
2183,14969,3,222,1,14968,783764,75032,0,0
2184,15221,8620,253,200,15021,790365,74979,0,0
2185,15268,0,247,0,15268,805633,74732,0,0
2186,15503,0,235,0,15503,821136,74497,0,0
2187,15763,0,260,0,15763,836899,74237,0,0
2188,16001,0,238,0,16001,852900,73999,0,0
2189,16236,0,235,0,16236,869136,73764,0,0
2190,16490,0,254,0,16490,885626,73510,0,0
2191,16759,0,269,0,16759,902385,73241,0,0
2192,16993,0,234,0,16993,919378,73007,0,0
2193,17257,0,264,0,17257,936635,72743,0,0
2194,17474,0,217,0,17474,954109,72526,0,0
2195,17735,0,261,0,17735,971844,72265,0,0
2196,18004,0,269,0,18004,989848,71996,0,0
2197,18237,0,233,0,18237,1008085,71763,0,0
2198,18487,0,250,0,18487,1026572,71513,0,0
2199,18736,0,249,0,18736,1045308,71264,0,0
2200,19014,28071,278,476,18538,1036251,71462,0,0
2201,18788,0,250,0,18788,1055039,71212,0,0
2202,19030,0,242,0,19030,1074069,70970,0,0
2203,19267,0,237,0,19267,1093336,70733,0,0
2204,19546,0,279,0,19546,1112882,70454,0,0
2205,19824,37445,278,817,19007,1095261,70993,0,0
2206,19264,0,257,0,19264,1114525,70736,0,0
2207,19520,0,256,0,19520,1134045,70480,0,0
2208,19796,0,276,0,19796,1153841,70204,0,0
2209,20087,0,291,0,20087,1173928,69913,0,0
2210,20332,0,245,0,20332,1194260,69668,0,0
2211,20613,0,281,0,20613,1214873,69387,0,0
2212,20873,0,260,0,20873,1235746,69127,0,0
2213,21133,0,260,0,21133,1256879,68867,0,0
2214,21424,0,291,0,21424,1278303,68576,0,0
2215,21711,327352,287,4173,17538,972662,72462,0,0
2216,17772,0,234,0,17772,990434,72228,0,0
2217,18037,0,265,0,18037,1008471,71963,0,0
2218,18268,0,231,0,18268,1026739,71732,0,0
2219,18512,0,244,0,18512,1045251,71488,0,0
2220,18786,28620,274,531,18255,1035417,71745,0,0
2221,18488,0,233,0,18488,1053905,71512,0,0
2222,18762,41654,274,755,18007,1031013,71993,0,0
2223,18243,0,236,0,18243,1049256,71757,0,0
2224,18514,0,271,0,18514,1067770,71486,0,0
2225,18774,0,260,0,18774,1086544,71226,0,0
2226,19022,0,248,0,19022,1105566,70978,0,0
2227,19284,0,262,0,19284,1124850,70716,0,0
2228,19544,8527,260,187,19357,1135867,70643,0,0
2229,19580,0,223,0,19580,1155447,70420,0,0
2230,19830,82835,250,939,18891,1092442,71109,0,0
2231,19139,9719,248,207,18932,1101862,71068,0,0
2232,19172,0,240,0,19172,1121034,70828,0,0
2233,19419,0,247,0,19419,1140453,70581,0,0
2234,19669,21266,250,452,19217,1138856,70783,0,0
2235,19470,0,253,0,19470,1158326,70530,0,0
2236,19737,0,267,0,19737,1178063,70263,0,0
2237,19984,0,247,0,19984,1198047,70016,0,0
2238,20224,0,240,0,20224,1218271,69776,0,0
2239,20462,74,238,6,20456,1238659,69544,0,0
2240,20689,4282,233,109,20580,1255066,69420,0,0
2241,20862,0,282,0,20862,1275928,69138,0,0
2242,21146,0,284,0,21146,1297074,68854,0,0
2243,21399,0,253,0,21399,1318473,68601,0,0
2244,21661,10,262,1,21660,1340124,68340,0,0
2245,21933,0,273,0,21933,1362057,68067,0,0
2246,22218,0,285,0,22218,1384275,67782,0,0
2247,22466,0,248,0,22466,1406741,67534,0,0
2248,22734,0,268,0,22734,1429475,67266,0,0
2249,23001,0,267,0,23001,1452476,66999,0,0
2250,23279,0,278,0,23279,1475755,66721,0,0
2251,23541,0,262,0,23541,1499296,66459,0,0
2252,23809,353487,268,3858,19951,1169618,70049,0,0
2253,20175,0,224,0,20175,1189793,69825,0,0
2254,20425,0,250,0,20425,1210218,69575,0,0
2255,20674,153011,249,2548,18126,1077881,71874,0,0
2256,18325,0,199,0,18325,1096206,71675,0,0
2257,18543,0,218,0,18543,1114749,71457,0,0
2258,18769,0,226,0,18769,1133518,71231,0,0
2259,18982,0,213,0,18982,1152500,71018,0,0
2260,19194,0,212,0,19194,1171694,70806,0,0
2261,19405,0,211,0,19405,1191099,70595,0,0
2262,19642,36663,237,608,19034,1174078,70966,0,0
2263,19279,179386,245,2579,16700,1013971,73300,0,0
2264,16902,229809,202,2722,14180,801064,75820,0,0
2265,14370,0,190,0,14370,815434,75630,0,0
2266,14573,0,203,0,14573,830007,75427,0,0
2267,14765,0,192,0,14765,844772,75235,0,0
2268,14963,0,198,0,14963,859735,75037,0,0
2269,15154,131407,191,1512,13642,743482,76358,0,0
2270,13832,0,190,0,13832,757314,76168,0,0
2271,14007,0,175,0,14007,771321,75993,0,0
2272,14185,0,178,0,14185,785506,75815,0,0
2273,14372,0,187,0,14372,799878,75628,0,0
2274,14557,0,185,0,14557,814435,75443,0,0
2275,14755,0,198,0,14755,829190,75245,0,0
2276,14953,0,198,0,14953,844143,75047,0,0
2277,15143,0,190,0,15143,859286,74857,0,0
2278,15320,0,177,0,15320,874606,74680,0,0
2279,15487,22636,167,484,15003,867457,74997,0,0
2280,15183,0,180,0,15183,882640,74817,0,0
2281,15394,0,211,0,15394,898034,74606,0,0
2282,15618,0,224,0,15618,913652,74382,0,0
2283,15825,0,207,0,15825,929477,74175,0,0
2284,16008,0,183,0,16008,945485,73992,0,0
2285,16218,0,210,0,16218,961703,73782,0,0
2286,16430,0,212,0,16430,978133,73570,0,0
2287,16618,0,188,0,16618,994751,73382,0,0
2288,16831,0,213,0,16831,1011582,73169,0,0
2289,17036,0,205,0,17036,1028618,72964,0,0
2290,17240,0,204,0,17240,1045858,72760,0,0
2291,17424,0,184,0,17424,1063282,72576,0,0
2292,17601,228832,177,3025,14576,852051,75424,0,0
2293,14764,0,188,0,14764,866815,75236,0,0
2294,14939,0,175,0,14939,881754,75061,0,0
2295,15127,0,188,0,15127,896881,74873,0,0
2296,15328,0,201,0,15328,912209,74672,0,0
2297,15529,0,201,0,15529,927738,74471,0,0
2298,15709,152390,180,2156,13553,791057,76447,0,0
2299,13733,0,180,0,13733,804790,76267,0,0
2300,13894,0,161,0,13894,818684,76106,0,0
2301,14088,0,194,0,14088,832772,75912,0,0
2302,14274,0,186,0,14274,847046,75726,0,0
2303,14441,0,167,0,14441,861487,75559,0,0
2304,14623,0,182,0,14623,876110,75377,0,0
2305,14812,0,189,0,14812,890922,75188,0,0
2306,15009,0,197,0,15009,905931,74991,0,0
2307,15188,0,179,0,15188,921119,74812,0,0
2308,15375,4177,187,120,15255,932317,74745,0,0
2309,15430,0,175,0,15430,947747,74570,0,0
2310,15634,0,204,0,15634,963381,74366,0,0
2311,15796,0,162,0,15796,979177,74204,0,0
2312,15997,0,201,0,15997,995174,74003,0,0
2313,16200,0,203,0,16200,1011374,73800,0,0
2314,16393,0,193,0,16393,1027767,73607,0,0
2315,16595,0,202,0,16595,1044362,73405,0,0
2316,16795,828,200,42,16753,1060329,73247,0,0
2317,16952,0,199,0,16952,1077281,73048,0,0
2318,17166,190231,214,2471,14695,904216,75305,0,0
2319,14889,11449,194,231,14658,907656,75342,0,0
2320,14825,0,167,0,14825,922481,75175,0,0
2321,15022,0,197,0,15022,937503,74978,0,0
2322,15192,0,170,0,15192,952695,74808,0,0
2323,15350,0,158,0,15350,968045,74650,0,0
2324,15536,0,186,0,15536,983581,74464,0,0
2325,15705,0,169,0,15705,999286,74295,0,0
2326,15887,17796,182,315,15572,997377,74428,0,0
2327,15761,0,189,0,15761,1013138,74239,0,0
2328,15938,0,177,0,15938,1029076,74062,0,0
2329,16136,0,198,0,16136,1045212,73864,0,0
2330,16318,67903,182,976,15342,993627,74658,0,0
2331,15538,0,196,0,15538,1009165,74462,0,0
2332,15732,0,194,0,15732,1024897,74268,0,0
2333,15938,9205,206,201,15737,1031630,74263,0,0
2334,15906,0,169,0,15906,1047536,74094,0,0
2335,16083,77836,177,1123,14960,985783,75040,0,0
2336,15154,0,194,0,15154,1000937,74846,0,0
2337,15340,53992,186,726,14614,962285,75386,0,0
2338,14786,0,172,0,14786,977071,75214,0,0
2339,14969,0,183,0,14969,992040,75031,0,0
2340,15157,95832,188,1247,13910,911365,76090,0,0
2341,14106,0,196,0,14106,925471,75894,0,0
2342,14288,0,182,0,14288,939759,75712,0,0
2343,14472,176471,184,2037,12435,777760,77565,0,0
2344,12584,0,149,0,12584,790344,77416,0,0
2345,12722,0,138,0,12722,803066,77278,0,0
2346,12897,0,175,0,12897,815963,77103,0,0
2347,13078,0,181,0,13078,829041,76922,0,0
2348,13246,293980,168,3428,9818,548307,80182,0,0
2349,9974,0,156,0,9974,558281,80026,0,0
2350,10132,0,158,0,10132,568413,79868,0,0
2351,10308,0,176,0,10308,578721,79692,0,0
2352,10450,0,142,0,10450,589171,79550,0,0
2353,10612,0,162,0,10612,599783,79388,0,0
2354,10756,0,144,0,10756,610539,79244,0,0
2355,10913,0,157,0,10913,621452,79087,0,0
2356,11093,0,180,0,11093,632545,78907,0,0
2357,11264,0,171,0,11264,643809,78736,0,0
2358,11430,0,166,0,11430,655239,78570,0,0
2359,11595,0,165,0,11595,666834,78405,0,0
2360,11778,0,183,0,11778,678612,78222,0,0
2361,11959,0,181,0,11959,690571,78041,0,0
2362,12115,0,156,0,12115,702686,77885,0,0
2363,12301,0,186,0,12301,714987,77699,0,0
2364,12447,0,146,0,12447,727434,77553,0,0
2365,12652,0,205,0,12652,740086,77348,0,0
2366,12833,0,181,0,12833,752919,77167,0,0
2367,13011,0,178,0,13011,765930,76989,0,0
2368,13185,0,174,0,13185,779115,76815,0,0
2369,13364,0,179,0,13364,792479,76636,0,0
2370,13564,0,200,0,13564,806043,76436,0,0
2371,13789,0,225,0,13789,819832,76211,0,0
2372,13985,0,196,0,13985,833817,76015,0,0
2373,14178,12319,193,243,13935,835676,76065,0,0
2374,14117,0,182,0,14117,849793,75883,0,0
2375,14324,0,207,0,14324,864117,75676,0,0
2376,14514,0,190,0,14514,878631,75486,0,0
2377,14717,107150,203,1303,13414,786198,76586,0,0
2378,13606,0,192,0,13606,799804,76394,0,0
2379,13786,0,180,0,13786,813590,76214,0,0
2380,13986,0,200,0,13986,827576,76014,0,0
2381,14189,0,203,0,14189,841765,75811,0,0
2382,14378,0,189,0,14378,856143,75622,0,0
2383,14569,0,191,0,14569,870712,75431,0,0
2384,14762,1585,193,54,14708,883889,75292,0,0
2385,14908,89619,200,1451,13457,809178,76543,0,0
2386,13647,0,190,0,13647,822825,76353,0,0
2387,13814,0,167,0,13814,836639,76186,0,0
2388,14010,0,196,0,14010,850649,75990,0,0
2389,14200,0,190,0,14200,864849,75800,0,0
2390,14418,0,218,0,14418,879267,75582,0,0
2391,14618,19891,200,370,14248,873994,75752,0,0
2392,14429,0,181,0,14429,888423,75571,0,0
2393,14641,163082,212,1466,13175,739982,76825,0,0
2394,13369,0,194,0,13369,753351,76631,0,0
2395,13531,0,162,0,13531,766882,76469,0,0
2396,13731,0,200,0,13731,780613,76269,0,0
2397,13934,0,203,0,13934,794547,76066,0,0
2398,14129,0,195,0,14129,808676,75871,0,0
2399,14322,0,193,0,14322,822998,75678,0,0
2400,14530,0,208,0,14530,837528,75470,0,0
2401,14730,180302,200,1798,12932,671956,77068,0,0
2402,13109,0,177,0,13109,685065,76891,0,0
2403,13311,86449,202,933,12378,611927,77622,0,0
2404,12553,0,175,0,12553,624480,77447,0,0
2405,12751,1597,198,62,12689,635634,77311,0,0
2406,12882,0,193,0,12882,648516,77118,0,0
2407,13078,46874,196,700,12378,614720,77622,0,0
2408,12583,0,205,0,12583,627303,77417,0,0
2409,12783,0,200,0,12783,640086,77217,0,0
2410,12954,0,171,0,12954,653040,77046,0,0
2411,13157,0,203,0,13157,666197,76843,0,0
2412,13342,0,185,0,13342,679539,76658,0,0
2413,13539,40208,197,656,12883,652870,77117,0,0
2414,13090,0,207,0,13090,665960,76910,0,0
2415,13273,0,183,0,13273,679233,76727,0,0
2416,13488,0,215,0,13488,692721,76512,0,0
2417,13669,0,181,0,13669,706390,76331,0,0
2418,13874,0,205,0,13874,720264,76126,0,0
2419,14093,0,219,0,14093,734357,75907,0,0
2420,14309,0,216,0,14309,748666,75691,0,0
2421,14532,0,223,0,14532,763198,75468,0,0
2422,14739,0,207,0,14739,777937,75261,0,0
2423,14971,0,232,0,14971,792908,75029,0,0
2424,15181,0,210,0,15181,808089,74819,0,0
2425,15393,0,212,0,15393,823482,74607,0,0
2426,15616,0,223,0,15616,839098,74384,0,0
2427,15820,0,204,0,15820,854918,74180,0,0
2428,16041,0,221,0,16041,870959,73959,0,0
2429,16256,0,215,0,16256,887215,73744,0,0
2430,16494,0,238,0,16494,903709,73506,0,0
2431,16725,0,231,0,16725,920434,73275,0,0
2432,16938,0,213,0,16938,937372,73062,0,0
2433,17174,0,236,0,17174,954546,72826,0,0
2434,17388,0,214,0,17388,971934,72612,0,0
2435,17619,0,231,0,17619,989553,72381,0,0
2436,17877,0,258,0,17877,1007430,72123,0,0
2437,18103,1181,226,51,18052,1024352,71948,0,0
2438,18292,145287,240,1674,16618,897357,73382,0,0
2439,16821,0,203,0,16821,914178,73179,0,0
2440,17052,0,231,0,17052,931230,72948,0,0
2441,17273,0,221,0,17273,948503,72727,0,0
2442,17502,0,229,0,17502,966005,72498,0,0
2443,17732,0,230,0,17732,983737,72268,0,0
2444,17953,0,221,0,17953,1001690,72047,0,0
2445,18185,41766,232,764,17421,978109,72579,0,0
2446,17650,0,229,0,17650,995759,72350,0,0
2447,17902,0,252,0,17902,1013661,72098,0,0
2448,18133,0,231,0,18133,1031794,71867,0,0
2449,18392,0,259,0,18392,1050186,71608,0,0
2450,18660,0,268,0,18660,1068846,71340,0,0
2451,18901,0,241,0,18901,1087747,71099,0,0
2452,19139,0,238,0,19139,1106886,70861,0,0
2453,19376,0,237,0,19376,1126262,70624,0,0
2454,19624,0,248,0,19624,1145886,70376,0,0
2455,19873,0,249,0,19873,1165759,70127,0,0
2456,20100,85735,227,1507,18593,1100124,71407,0,0
2457,18847,0,254,0,18847,1118971,71153,0,0
2458,19044,0,197,0,19044,1138015,70956,0,0
2459,19264,0,220,0,19264,1157279,70736,0,0
2460,19467,0,203,0,19467,1176746,70533,0,0
2461,19707,0,240,0,19707,1196453,70293,0,0
2462,19966,0,259,0,19966,1216419,70034,0,0
2463,20188,0,222,0,20188,1236607,69812,0,0
2464,20427,0,239,0,20427,1257034,69573,0,0
2465,20678,0,251,0,20678,1277712,69322,0,0
2466,20919,0,241,0,20919,1298631,69081,0,0
2467,21143,0,224,0,21143,1319774,68857,0,0
2468,21386,0,243,0,21386,1341160,68614,0,0
2469,21646,38482,260,749,20897,1324324,69103,0,0
2470,21142,0,245,0,21142,1345466,68858,0,0
2471,21358,0,216,0,21358,1366824,68642,0,0
2472,21584,0,226,0,21584,1388408,68416,0,0
2473,21811,0,227,0,21811,1410219,68189,0,0
2474,22042,0,231,0,22042,1432261,67958,0,0
2475,22347,675288,305,8896,13451,779320,76549,0,0
2476,13629,0,178,0,13629,792949,76371,0,0
2477,13801,0,172,0,13801,806750,76199,0,0
2478,13983,0,182,0,13983,820733,76017,0,0
2479,14137,0,154,0,14137,834870,75863,0,0
2480,14300,0,163,0,14300,849170,75700,0,0
2481,14492,0,192,0,14492,863662,75508,0,0
2482,14661,0,169,0,14661,878323,75339,0,0
2483,14828,0,167,0,14828,893151,75172,0,0
2484,15002,0,174,0,15002,908153,74998,0,0
2485,15181,52873,179,840,14341,870461,75659,0,0
2486,14523,36392,182,641,13882,848592,76118,0,0
2487,14062,0,180,0,14062,862654,75938,0,0
2488,14224,57512,162,799,13425,819366,76575,0,0
2489,13608,0,183,0,13608,832974,76392,0,0
2490,13792,0,184,0,13792,846766,76208,0,0
2491,13953,0,161,0,13953,860719,76047,0,0
2492,14122,0,169,0,14122,874841,75878,0,0
2493,14285,0,163,0,14285,889126,75715,0,0
2494,14463,0,178,0,14463,903589,75537,0,0
2495,14657,0,194,0,14657,918246,75343,0,0
2496,14844,0,187,0,14844,933090,75156,0,0
2497,15009,0,165,0,15009,948099,74991,0,0
2498,15179,57217,170,671,14508,906061,75492,0,0
2499,14686,0,178,0,14686,920747,75314,0,0
2500,14836,0,150,0,14836,935583,75164,0,0
2501,15009,100826,173,1443,13566,849766,76434,0,0
2502,13728,0,162,0,13728,863494,76272,0,0
2503,13905,0,177,0,13905,877399,76095,0,0
2504,14104,0,199,0,14104,891503,75896,0,0
2505,14272,0,168,0,14272,905775,75728,0,0
2506,14454,0,182,0,14454,920229,75546,0,0
2507,14619,0,165,0,14619,934848,75381,0,0
2508,14808,0,189,0,14808,949656,75192,0,0
2509,14988,0,180,0,14988,964644,75012,0,0
2510,15158,0,170,0,15158,979802,74842,0,0
2511,15342,0,184,0,15342,995144,74658,0,0
2512,15521,0,179,0,15521,1010665,74479,0,0
2513,15715,0,194,0,15715,1026380,74285,0,0
2514,15907,0,192,0,15907,1042287,74093,0,0
2515,16107,0,200,0,16107,1058394,73893,0,0
2516,16300,0,193,0,16300,1074694,73700,0,0
2517,16477,0,177,0,16477,1091171,73523,0,0
2518,16706,0,229,0,16706,1107877,73294,0,0
2519,16882,0,176,0,16882,1124759,73118,0,0
2520,17089,0,207,0,17089,1141848,72911,0,0
2521,17293,0,204,0,17293,1159141,72707,0,0
2522,17483,0,190,0,17483,1176624,72517,0,0
2523,17665,0,182,0,17665,1194289,72335,0,0
2524,17864,0,199,0,17864,1212153,72136,0,0
2525,18048,0,184,0,18048,1230201,71952,0,0
2526,18259,379135,211,4713,13546,869325,76454,0,0
2527,13725,0,179,0,13725,883050,76275,0,0
2528,13887,124608,162,1629,12258,772329,77742,0,0
2529,12411,0,153,0,12411,784740,77589,0,0
2530,12587,0,176,0,12587,797327,77413,0,0
2531,12739,1040,152,47,12692,809026,77308,0,0
2532,12860,0,168,0,12860,821886,77140,0,0
2533,13045,0,185,0,13045,834931,76955,0,0
2534,13229,0,184,0,13229,848160,76771,0,0
2535,13384,0,155,0,13384,861544,76616,0,0
2536,13565,0,181,0,13565,875109,76435,0,0
2537,13738,0,173,0,13738,888847,76262,0,0
2538,13921,0,183,0,13921,902768,76079,0,0
2539,14094,0,173,0,14094,916862,75906,0,0
2540,14300,0,206,0,14300,931162,75700,0,0
2541,14482,0,182,0,14482,945644,75518,0,0
2542,14655,0,173,0,14655,960299,75345,0,0
2543,14840,6675,185,159,14681,968464,75319,0,0
2544,14854,0,173,0,14854,983318,75146,0,0
2545,15028,1192,174,49,14979,997154,75021,0,0
2546,15164,0,185,0,15164,1012318,74836,0,0
2547,15351,68880,187,1028,14323,958789,75677,0,0
2548,14502,0,179,0,14502,973291,75498,0,0
2549,14693,0,191,0,14693,987984,75307,0,0
2550,14895,0,202,0,14895,1002879,75105,0,0
2551,15080,21285,185,334,14746,996674,75254,0,0
2552,14923,132018,177,1419,13504,879579,76496,0,0
2553,13697,0,193,0,13697,893276,76303,0,0
2554,13854,0,157,0,13854,907130,76146,0,0
2555,14028,0,174,0,14028,921158,75972,0,0
2556,14217,0,189,0,14217,935375,75783,0,0
2557,14400,0,183,0,14400,949775,75600,0,0
2558,14563,0,163,0,14563,964338,75437,0,0
2559,14755,0,192,0,14755,979093,75245,0,0
2560,14909,0,154,0,14909,994002,75091,0,0
2561,15059,0,150,0,15059,1009061,74941,0,0
2562,15233,0,174,0,15233,1024294,74767,0,0
2563,15417,0,184,0,15417,1039711,74583,0,0
2564,15613,0,196,0,15613,1055324,74387,0,0
2565,15815,0,202,0,15815,1071139,74185,0,0
2566,15988,0,173,0,15988,1087127,74012,0,0
2567,16171,42477,183,475,15696,1060821,74304,0,0
2568,15886,0,190,0,15886,1076707,74114,0,0
2569,16105,475,219,31,16074,1092337,73926,0,0
2570,16278,0,204,0,16278,1108615,73722,0,0
2571,16501,0,223,0,16501,1125116,73499,0,0
2572,16710,0,209,0,16710,1141826,73290,0,0
2573,16902,0,192,0,16902,1158728,73098,0,0
2574,17097,0,195,0,17097,1175825,72903,0,0
2575,17304,42221,207,601,16703,1150908,73297,0,0
2576,16891,0,188,0,16891,1167799,73109,0,0
2577,17074,0,183,0,17074,1184873,72926,0,0
2578,17299,0,225,0,17299,1202172,72701,0,0
2579,17494,0,195,0,17494,1219666,72506,0,0
2580,17702,0,208,0,17702,1237368,72298,0,0
2581,17889,0,187,0,17889,1255257,72111,0,0
2582,18098,0,209,0,18098,1273355,71902,0,0
2583,18320,0,222,0,18320,1291675,71680,0,0
2584,18527,0,207,0,18527,1310202,71473,0,0
2585,18748,0,221,0,18748,1328950,71252,0,0
2586,18966,0,218,0,18966,1347916,71034,0,0
2587,19183,0,217,0,19183,1367099,70817,0,0
2588,19400,146251,217,1802,17598,1240248,72402,0,0
2589,17816,3569,218,108,17708,1254495,72292,0,0
2590,17888,0,180,0,17888,1272383,72112,0,0
2591,18094,0,206,0,18094,1290477,71906,0,0
2592,18305,0,211,0,18305,1308782,71695,0,0
2593,18501,0,196,0,18501,1327283,71499,0,0
2594,18701,0,200,0,18701,1345984,71299,0,0
2595,18910,1915,209,70,18840,1362979,71160,0,0
2596,19083,0,243,0,19083,1382062,70917,0,0
2597,19287,10380,204,250,19037,1390969,70963,0,0
2598,19254,0,217,0,19254,1410223,70746,0,0
2599,19471,0,217,0,19471,1429694,70529,0,0
2600,19693,0,222,0,19693,1449387,70307,0,0
2601,19917,0,224,0,19917,1469304,70083,0,0
2602,20129,0,212,0,20129,1489433,69871,0,0
2603,20331,0,202,0,20331,1509764,69669,0,0
2604,20583,0,252,0,20583,1530347,69417,0,0
2605,20807,0,224,0,20807,1551154,69193,0,0
2606,20999,0,192,0,20999,1572153,69001,0,0
2607,21243,106699,244,1323,19920,1486697,70080,0,0
2608,20128,0,208,0,20128,1506825,69872,0,0
2609,20325,0,197,0,20325,1527150,69675,0,0
2610,20553,0,228,0,20553,1547703,69447,0,0
2611,20762,0,209,0,20762,1568465,69238,0,0
2612,20973,0,211,0,20973,1589438,69027,0,0
2613,21183,0,210,0,21183,1610621,68817,0,0
2614,21414,790067,231,7224,14190,841968,75810,0,0
2615,14371,0,181,0,14371,856339,75629,0,0
2616,14556,0,185,0,14556,870895,75444,0,0
2617,14768,0,212,0,14768,885663,75232,0,0
2618,14965,0,197,0,14965,900628,75035,0,0
2619,15171,16206,206,220,14951,899593,75049,0,0
2620,15149,34817,198,583,14566,879925,75434,0,0
2621,14748,0,182,0,14748,894673,75252,0,0
2622,14945,0,197,0,14945,909618,75055,0,0
2623,15140,0,195,0,15140,924758,74860,0,0
2624,15342,0,202,0,15342,940100,74658,0,0
2625,15546,55279,204,825,14721,900367,75279,0,0
2626,14907,0,186,0,14907,915274,75093,0,0
2627,15101,0,194,0,15101,930375,74899,0,0
2628,15296,0,195,0,15296,945671,74704,0,0
2629,15499,0,203,0,15499,961170,74501,0,0
2630,15694,0,195,0,15694,976864,74306,0,0
2631,15892,21361,198,356,15536,971395,74464,0,0
2632,15702,0,166,0,15702,987097,74298,0,0
2633,15926,0,224,0,15926,1003023,74074,0,0
2634,16131,0,205,0,16131,1019154,73869,0,0
2635,16317,0,186,0,16317,1035471,73683,0,0
2636,16514,0,197,0,16514,1051985,73486,0,0
2637,16725,0,211,0,16725,1068710,73275,0,0
2638,16910,0,185,0,16910,1085620,73090,0,0
2639,17112,53732,202,899,16213,1049000,73787,0,0
2640,16402,0,189,0,16402,1065402,73598,0,0
2641,16581,0,179,0,16581,1081983,73419,0,0
2642,16794,0,213,0,16794,1098777,73206,0,0
2643,16991,0,197,0,16991,1115768,73009,0,0
2644,17205,0,214,0,17205,1132973,72795,0,0
2645,17435,0,230,0,17435,1150408,72565,0,0
2646,17648,0,213,0,17648,1168056,72352,0,0
2647,17856,6633,208,193,17663,1179279,72337,0,0
2648,17881,0,218,0,17881,1197160,72119,0,0
2649,18091,0,210,0,18091,1215251,71909,0,0
2650,18312,0,221,0,18312,1233563,71688,0,0
2651,18537,0,225,0,18537,1252100,71463,0,0
2652,18719,205598,182,2068,16651,1065221,73349,0,0
2653,16849,0,198,0,16849,1082070,73151,0,0
2654,17035,21526,186,358,16677,1077579,73323,0,0
2655,16886,0,209,0,16886,1094465,73114,0,0
2656,17092,0,206,0,17092,1111557,72908,0,0
2657,17306,0,214,0,17306,1128863,72694,0,0
2658,17510,0,204,0,17510,1146373,72490,0,0
2659,17709,0,199,0,17709,1164082,72291,0,0
2660,17913,0,204,0,17913,1181995,72087,0,0
2661,18104,0,191,0,18104,1200099,71896,0,0
2662,18340,0,236,0,18340,1218439,71660,0,0
2663,18539,0,199,0,18539,1236978,71461,0,0
2664,18759,22031,220,499,18260,1233706,71740,0,0
2665,18452,0,192,0,18452,1252158,71548,0,0
2666,18662,0,210,0,18662,1270820,71338,0,0
2667,18878,0,216,0,18878,1289698,71122,0,0
2668,19092,0,214,0,19092,1308790,70908,0,0
2669,19310,3643,218,109,19201,1324457,70799,0,0
2670,19409,0,208,0,19409,1343866,70591,0,0
2671,19625,0,216,0,19625,1363491,70375,0,0
2672,19826,0,201,0,19826,1383317,70174,0,0
2673,20032,0,206,0,20032,1403349,69968,0,0
2674,20256,0,224,0,20256,1423605,69744,0,0
2675,20485,0,229,0,20485,1444090,69515,0,0
2676,20703,0,218,0,20703,1464793,69297,0,0
2677,20942,0,239,0,20942,1485735,69058,0,0
2678,21162,0,220,0,21162,1506897,68838,0,0
2679,21388,2419,226,89,21299,1525866,68701,0,0
2680,21527,0,228,0,21527,1547393,68473,0,0
2681,21787,0,260,0,21787,1569180,68213,0,0
2682,22000,0,213,0,22000,1591180,68000,0,0
2683,22232,0,232,0,22232,1613412,67768,0,0
2684,22461,0,229,0,22461,1635873,67539,0,0
2685,22675,0,214,0,22675,1658548,67325,0,0
2686,22901,0,226,0,22901,1681449,67099,0,0
2687,23115,0,214,0,23115,1704564,66885,0,0
2688,23363,408695,248,4920,18443,1319232,71557,0,0
2689,18654,0,211,0,18654,1337886,71346,0,0
2690,18855,0,201,0,18855,1356741,71145,0,0
2691,19075,0,220,0,19075,1375816,70925,0,0
2692,19255,847719,180,9387,9868,547352,80132,0,0
2693,10015,0,147,0,10015,557367,79985,0,0
2694,10155,0,140,0,10155,567522,79845,0,0
2695,10300,0,145,0,10300,577822,79700,0,0
2696,10453,0,153,0,10453,588275,79547,0,0
2697,10612,0,159,0,10612,598887,79388,0,0
2698,10758,0,146,0,10758,609645,79242,0,0
2699,10919,0,161,0,10919,620564,79081,0,0
2700,11076,0,157,0,11076,631640,78924,0,0
2701,11249,0,173,0,11249,642889,78751,0,0
2702,11419,0,170,0,11419,654308,78581,0,0
2703,11587,4859,168,141,11446,661036,78554,0,0
2704,11625,0,179,0,11625,672661,78375,0,0
2705,11801,0,176,0,11801,684462,78199,0,0
2706,11969,0,168,0,11969,696431,78031,0,0
2707,12140,0,171,0,12140,708571,77860,0,0
2708,12291,0,151,0,12291,720862,77709,0,0
2709,12454,0,163,0,12454,733316,77546,0,0
2710,12647,0,193,0,12647,745963,77353,0,0
2711,12821,0,174,0,12821,758784,77179,0,0
2712,13000,0,179,0,13000,771784,77000,0,0
2713,13209,0,209,0,13209,784993,76791,0,0
2714,13389,0,180,0,13389,798382,76611,0,0
2715,13568,0,179,0,13568,811950,76432,0,0
2716,13781,0,213,0,13781,825731,76219,0,0
2717,13962,0,181,0,13962,839693,76038,0,0
2718,14157,0,195,0,14157,853850,75843,0,0
2719,14334,74464,177,1012,13322,793720,76678,0,0
2720,13510,0,188,0,13510,807230,76490,0,0
2721,13676,0,166,0,13676,820906,76324,0,0
2722,13880,0,204,0,13880,834786,76120,0,0
2723,14061,0,181,0,14061,848847,75939,0,0
2724,14219,174884,158,2210,12009,688182,77991,0,0
2725,12192,0,183,0,12192,700374,77808,0,0
2726,12344,0,152,0,12344,712718,77656,0,0
2727,12513,0,169,0,12513,725231,77487,0,0
2728,12665,0,152,0,12665,737896,77335,0,0
2729,12856,0,191,0,12856,750752,77144,0,0
2730,13050,0,194,0,13050,763802,76950,0,0
2731,13258,0,208,0,13258,777060,76742,0,0
2732,13440,0,182,0,13440,790500,76560,0,0
2733,13620,0,180,0,13620,804120,76380,0,0
2734,13830,0,210,0,13830,817950,76170,0,0
2735,14027,0,197,0,14027,831977,75973,0,0
2736,14209,0,182,0,14209,846186,75791,0,0
2737,14423,0,214,0,14423,860609,75577,0,0
2738,14596,0,173,0,14596,875205,75404,0,0
2739,14779,0,183,0,14779,889984,75221,0,0
2740,14961,0,182,0,14961,904945,75039,0,0
2741,15153,158996,192,1959,13194,761102,76806,0,0
2742,13374,0,180,0,13374,774476,76626,0,0
2743,13556,167010,182,2208,11348,621022,78652,0,0
2744,11522,0,174,0,11522,632544,78478,0,0
2745,11695,0,173,0,11695,644239,78305,0,0
2746,11860,0,165,0,11860,656099,78140,0,0
2747,12021,0,161,0,12021,668120,77979,0,0
2748,12198,0,177,0,12198,680318,77802,0,0
2749,12394,0,196,0,12394,692712,77606,0,0
2750,12594,11365,200,249,12345,693941,77655,0,0
2751,12508,0,163,0,12508,706449,77492,0,0
2752,12697,0,189,0,12697,719146,77303,0,0
2753,12873,0,176,0,12873,732019,77127,0,0
2754,13063,0,190,0,13063,745082,76937,0,0
2755,13240,0,177,0,13240,758322,76760,0,0
2756,13435,0,195,0,13435,771757,76565,0,0
2757,13638,0,203,0,13638,785395,76362,0,0
2758,13859,0,221,0,13859,799254,76141,0,0
2759,14061,0,202,0,14061,813315,75939,0,0
2760,14251,0,190,0,14251,827566,75749,0,0
2761,14460,0,209,0,14460,842026,75540,0,0
2762,14673,0,213,0,14673,856699,75327,0,0
2763,14858,0,185,0,14858,871557,75142,0,0
2764,15071,0,213,0,15071,886628,74929,0,0
2765,15261,0,190,0,15261,901889,74739,0,0
2766,15461,0,200,0,15461,917350,74539,0,0
2767,15681,0,220,0,15681,933031,74319,0,0
2768,15891,0,210,0,15891,948922,74109,0,0
2769,16102,0,211,0,16102,965024,73898,0,0
2770,16320,0,218,0,16320,981344,73680,0,0
2771,16551,0,231,0,16551,997895,73449,0,0
2772,16768,0,217,0,16768,1014663,73232,0,0
2773,16987,0,219,0,16987,1031650,73013,0,0
2774,17207,0,220,0,17207,1048857,72793,0,0
2775,17432,0,225,0,17432,1066289,72568,0,0
2776,17652,0,220,0,17652,1083941,72348,0,0
2777,17886,0,234,0,17886,1101827,72114,0,0
2778,18096,124674,210,1953,16143,995249,73857,0,0
2779,16358,0,215,0,16358,1011607,73642,0,0
2780,16570,74058,212,808,15762,954119,74238,0,0
2781,15978,0,216,0,15978,970097,74022,0,0
2782,16179,238149,201,2690,13489,748127,76511,0,0
2783,13688,0,199,0,13688,761815,76312,0,0
2784,13875,0,187,0,13875,775690,76125,0,0
2785,14080,0,205,0,14080,789770,75920,0,0
2786,14276,0,196,0,14276,804046,75724,0,0
2787,14454,0,178,0,14454,818500,75546,0,0
2788,14653,0,199,0,14653,833153,75347,0,0
2789,14838,0,185,0,14838,847991,75162,0,0
2790,15020,0,182,0,15020,863011,74980,0,0
2791,15206,0,186,0,15206,878217,74794,0,0
2792,15413,0,207,0,15413,893630,74587,0,0
2793,15619,0,206,0,15619,909249,74381,0,0
2794,15826,0,207,0,15826,925075,74174,0,0
2795,16033,0,207,0,16033,941108,73967,0,0
2796,16261,0,228,0,16261,957369,73739,0,0
2797,16480,0,219,0,16480,973849,73520,0,0
2798,16694,0,214,0,16694,990543,73306,0,0
2799,16888,203868,194,2294,14594,803563,75406,0,0
2800,14803,0,209,0,14803,818366,75197,0,0
2801,15018,0,215,0,15018,833384,74982,0,0
2802,15224,0,206,0,15224,848608,74776,0,0
2803,15428,0,204,0,15428,864036,74572,0,0
2804,15636,0,208,0,15636,879672,74364,0,0
2805,15866,53815,230,972,14894,841723,75106,0,0
2806,15098,0,204,0,15098,856821,74902,0,0
2807,15301,0,203,0,15301,872122,74699,0,0
2808,15498,0,197,0,15498,887620,74502,0,0
2809,15707,0,209,0,15707,903327,74293,0,0
2810,15905,62113,198,818,15087,857119,74913,0,0
2811,15295,0,208,0,15295,872414,74705,0,0
2812,15512,0,217,0,15512,887926,74488,0,0
2813,15717,0,205,0,15717,903643,74283,0,0
2814,15946,0,229,0,15946,919589,74054,0,0
2815,16145,0,199,0,16145,935734,73855,0,0
2816,16367,0,222,0,16367,952101,73633,0,0
2817,16589,0,222,0,16589,968690,73411,0,0
2818,16803,0,214,0,16803,985493,73197,0,0
2819,17006,246888,203,3674,13332,755611,76668,0,0
2820,13502,74523,170,1125,12377,694590,77623,0,0
2821,12525,0,148,0,12525,707115,77475,0,0
2822,12708,0,183,0,12708,719823,77292,0,0
2823,12891,0,183,0,12891,732714,77109,0,0
2824,13072,0,181,0,13072,745786,76928,0,0
2825,13273,0,201,0,13273,759059,76727,0,0
2826,13456,0,183,0,13456,772515,76544,0,0
2827,13629,0,173,0,13629,786144,76371,0,0
2828,13821,0,192,0,13821,799965,76179,0,0
2829,14018,0,197,0,14018,813983,75982,0,0
2830,14227,0,209,0,14227,828210,75773,0,0
2831,14418,0,191,0,14418,842628,75582,0,0
2832,14621,0,203,0,14621,857249,75379,0,0
2833,14812,0,191,0,14812,872061,75188,0,0
2834,15013,0,201,0,15013,887074,74987,0,0
2835,15196,0,183,0,15196,902270,74804,0,0
2836,15402,0,206,0,15402,917672,74598,0,0
2837,15575,20059,173,360,15215,913188,74785,0,0
2838,15422,0,207,0,15422,928610,74578,0,0
2839,15648,0,226,0,15648,944258,74352,0,0
2840,15846,0,198,0,15846,960104,74154,0,0
2841,16050,0,204,0,16050,976154,73950,0,0
2842,16228,0,178,0,16228,992382,73772,0,0
2843,16442,0,214,0,16442,1008824,73558,0,0
2844,16627,0,185,0,16627,1025451,73373,0,0
2845,16824,0,197,0,16824,1042275,73176,0,0
2846,17029,0,205,0,17029,1059304,72971,0,0
2847,17247,0,218,0,17247,1076551,72753,0,0
2848,17468,151243,221,2124,15344,942776,74656,0,0
2849,15536,0,192,0,15536,958312,74464,0,0
2850,15752,0,216,0,15752,974064,74248,0,0
2851,15950,222662,198,2807,13143,767352,76857,0,0
2852,13321,0,178,0,13321,780673,76679,0,0
2853,13499,0,178,0,13499,794172,76501,0,0
2854,13679,0,180,0,13679,807851,76321,0,0
2855,13875,0,196,0,13875,821726,76125,0,0
2856,14076,78891,201,1070,13006,756911,76994,0,0
2857,13181,0,175,0,13181,770092,76819,0,0
2858,13390,0,209,0,13390,783482,76610,0,0
2859,13585,0,195,0,13585,797067,76415,0,0
2860,13757,0,172,0,13757,810824,76243,0,0
2861,13931,204201,174,2250,11681,620554,78319,0,0
2862,11858,0,177,0,11858,632412,78142,0,0
2863,12045,0,187,0,12045,644457,77955,0,0
2864,12238,0,193,0,12238,656695,77762,0,0
2865,12418,0,180,0,12418,669113,77582,0,0
2866,12598,0,180,0,12598,681711,77402,0,0
2867,12768,0,170,0,12768,694479,77232,0,0
2868,12925,0,157,0,12925,707404,77075,0,0
2869,13090,0,165,0,13090,720494,76910,0,0
2870,13255,0,165,0,13255,733749,76745,0,0
2871,13455,0,200,0,13455,747204,76545,0,0
2872,13649,0,194,0,13649,760853,76351,0,0
2873,13849,0,200,0,13849,774702,76151,0,0
2874,14032,0,183,0,14032,788734,75968,0,0
2875,14218,0,186,0,14218,802952,75782,0,0
2876,14417,0,199,0,14417,817369,75583,0,0
2877,14624,21201,207,457,14167,810792,75833,0,0
2878,14352,0,185,0,14352,825144,75648,0,0
2879,14541,0,189,0,14541,839685,75459,0,0
2880,14727,0,186,0,14727,854412,75273,0,0
2881,14947,0,220,0,14947,869359,75053,0,0
2882,15108,0,161,0,15108,884467,74892,0,0
2883,15295,0,187,0,15295,899762,74705,0,0
2884,15506,0,211,0,15506,915268,74494,0,0
2885,15708,107272,202,1425,14283,823704,75717,0,0
2886,14479,0,196,0,14479,838183,75521,0,0
2887,14691,0,212,0,14691,852874,75309,0,0
2888,14896,0,205,0,14896,867770,75104,0,0
2889,15117,3035,221,91,15026,879852,74974,0,0
2890,15218,0,192,0,15218,895070,74782,0,0
2891,15408,161976,190,2185,13223,748502,76777,0,0
2892,13388,0,165,0,13388,761890,76612,0,0
2893,13569,0,181,0,13569,775459,76431,0,0
2894,13750,0,181,0,13750,789209,76250,0,0
2895,13926,0,176,0,13926,803135,76074,0,0
2896,14115,79383,189,1251,12864,737867,77136,0,0
2897,13042,67566,178,779,12263,683343,77737,0,0
2898,12437,0,174,0,12437,695780,77563,0,0
2899,12579,0,142,0,12579,708359,77421,0,0
2900,12730,33194,151,626,12104,687895,77896,0,0
2901,12266,0,162,0,12266,700161,77734,0,0
2902,12449,0,183,0,12449,712610,77551,0,0
2903,12630,0,181,0,12630,725240,77370,0,0
2904,12810,0,180,0,12810,738050,77190,0,0
2905,12970,3656,160,125,12845,747364,77155,0,0
2906,13028,0,183,0,13028,760392,76972,0,0
2907,13187,0,159,0,13187,773579,76813,0,0
2908,13356,0,169,0,13356,786935,76644,0,0
2909,13523,0,167,0,13523,800458,76477,0,0
2910,13685,0,162,0,13685,814143,76315,0,0
2911,13853,0,168,0,13853,827996,76147,0,0
2912,14023,0,170,0,14023,842019,75977,0,0
2913,14202,0,179,0,14202,856221,75798,0,0
2914,14374,0,172,0,14374,870595,75626,0,0
2915,14547,112019,173,1546,13001,773123,76999,0,0
2916,13164,71080,163,987,12177,715207,77823,0,0
2917,12353,0,176,0,12353,727560,77647,0,0
2918,12529,0,176,0,12529,740089,77471,0,0
2919,12695,0,166,0,12695,752784,77305,0,0
2920,12870,0,175,0,12870,765654,77130,0,0
2921,13044,0,174,0,13044,778698,76956,0,0
2922,13198,0,154,0,13198,791896,76802,0,0
2923,13385,0,187,0,13385,805281,76615,0,0
2924,13548,29928,163,456,13092,788901,76908,0,0
2925,13242,0,150,0,13242,802143,76758,0,0
2926,13442,0,200,0,13442,815585,76558,0,0
2927,13603,0,161,0,13603,829188,76397,0,0
2928,13763,0,160,0,13763,842951,76237,0,0
2929,13948,0,185,0,13948,856899,76052,0,0
2930,14097,0,149,0,14097,870996,75903,0,0
2931,14264,40440,167,676,13588,844820,76412,0,0
2932,13786,0,198,0,13786,858606,76214,0,0
2933,13957,150339,171,2304,11653,722224,78347,0,0
2934,11770,0,117,0,11770,733994,78230,0,0
2935,11924,76713,154,1049,10875,669205,79125,0,0
2936,11030,0,155,0,11030,680235,78970,0,0
2937,11185,0,155,0,11185,691420,78815,0,0
2938,11355,0,170,0,11355,702775,78645,0,0
2939,11509,148566,154,1787,9722,565718,80278,0,0
2940,9874,101875,152,1222,8652,473717,81348,0,0
2941,8772,0,120,0,8772,482489,81228,0,0
2942,8885,0,113,0,8885,491374,81115,0,0
2943,9025,0,140,0,9025,500399,80975,0,0
2944,9178,0,153,0,9178,509577,80822,0,0
2945,9309,0,131,0,9309,518886,80691,0,0
2946,9449,0,140,0,9449,528335,80551,0,0
2947,9588,0,139,0,9588,537923,80412,0,0
2948,9757,0,169,0,9757,547680,80243,0,0
2949,9916,0,159,0,9916,557596,80084,0,0
2950,10062,0,146,0,10062,567658,79938,0,0
2951,10217,0,155,0,10217,577875,79783,0,0
2952,10359,0,142,0,10359,588234,79641,0,0
2953,10521,0,162,0,10521,598755,79479,0,0
2954,10674,0,153,0,10674,609429,79326,0,0
2955,10851,0,177,0,10851,620280,79149,0,0
2956,11021,0,170,0,11021,631301,78979,0,0
2957,11181,0,160,0,11181,642482,78819,0,0
2958,11344,0,163,0,11344,653826,78656,0,0
2959,11512,0,168,0,11512,665338,78488,0,0
2960,11678,0,166,0,11678,677016,78322,0,0
2961,11845,0,167,0,11845,688861,78155,0,0
2962,12000,45014,155,604,11396,655847,78604,0,0
2963,11554,0,158,0,11554,667401,78446,0,0
2964,11733,0,179,0,11733,679134,78267,0,0
2965,11916,0,183,0,11916,691050,78084,0,0
2966,12074,0,158,0,12074,703124,77926,0,0
2967,12243,0,169,0,12243,715367,77757,0,0
2968,12395,200483,152,2385,10010,527279,79990,0,0
2969,10209,6423,199,165,10044,531065,79956,0,0
2970,10207,0,163,0,10207,541272,79793,0,0
2971,10341,1034,134,46,10295,550579,79705,0,0
2972,10458,0,163,0,10458,561037,79542,0,0
2973,10639,0,181,0,10639,571676,79361,0,0
2974,10804,152344,165,1754,9050,430136,80950,0,0
2975,9211,0,161,0,9211,439347,80789,0,0
2976,9390,0,179,0,9390,448737,80610,0,0
2977,9570,0,180,0,9570,458307,80430,0,0
2978,9733,0,163,0,9733,468040,80267,0,0
2979,9903,0,170,0,9903,477943,80097,0,0
2980,10068,0,165,0,10068,488011,79932,0,0
2981,10246,0,178,0,10246,498257,79754,0,0
2982,10422,0,176,0,10422,508679,79578,0,0
2983,10582,0,160,0,10582,519261,79418,0,0
2984,10751,0,169,0,10751,530012,79249,0,0
2985,10929,5939,178,151,10778,535002,79222,0,0
2986,10953,0,175,0,10953,545955,79047,0,0
2987,11148,0,195,0,11148,557103,78852,0,0
2988,11335,0,187,0,11335,568438,78665,0,0
2989,11522,23917,187,406,11116,556043,78884,0,0
2990,11289,0,173,0,11289,567332,78711,0,0
2991,11494,0,205,0,11494,578826,78506,0,0
2992,11686,0,192,0,11686,590512,78314,0,0
2993,11854,0,168,0,11854,602366,78146,0,0
2994,12038,0,184,0,12038,614404,77962,0,0
2995,12235,0,197,0,12235,626639,77765,0,0
2996,12419,0,184,0,12419,639058,77581,0,0
2997,12630,0,211,0,12630,651688,77370,0,0
2998,12835,34669,205,531,12304,629854,77696,0,0
2999,12489,0,185,0,12489,642343,77511,0,0
3000,12678,0,189,0,12678,655021,77322,0,0
3001,12892,0,214,0,12892,667913,77108,0,0
3002,13142,0,250,0,13142,681055,76858,0,0
3003,13332,0,190,0,13332,694387,76668,0,0
3004,13532,0,200,0,13532,707919,76468,0,0
3005,13730,15254,198,359,13371,706395,76629,0,0
3006,13581,0,210,0,13581,719976,76419,0,0
3007,13773,0,192,0,13773,733749,76227,0,0
3008,14021,0,248,0,14021,747770,75979,0,0
3009,14227,0,206,0,14227,761997,75773,0,0
3010,14428,0,201,0,14428,776425,75572,0,0
3011,14658,0,230,0,14658,791083,75342,0,0
3012,14882,2659,224,83,14799,803306,75201,0,0
3013,14999,0,200,0,14999,818305,75001,0,0
3014,15208,0,209,0,15208,833513,74792,0,0
3015,15452,0,244,0,15452,848965,74548,0,0
3016,15677,0,225,0,15677,864642,74323,0,0
3017,15892,57871,215,819,15073,822663,74927,0,0
3018,15312,0,239,0,15312,837975,74688,0,0
3019,15524,40307,212,565,14959,813192,75041,0,0
3020,15195,0,236,0,15195,828387,74805,0,0
3021,15417,0,222,0,15417,843804,74583,0,0
3022,15616,0,199,0,15616,859420,74384,0,0
3023,15834,0,218,0,15834,875254,74166,0,0
3024,16059,0,225,0,16059,891313,73941,0,0
3025,16285,0,226,0,16285,907598,73715,0,0
3026,16518,0,233,0,16518,924116,73482,0,0
3027,16745,0,227,0,16745,940861,73255,0,0
3028,16992,66588,247,1143,15849,891265,74151,0,0
3029,16072,0,223,0,16072,907337,73928,0,0
3030,16274,0,202,0,16274,923611,73726,0,0
3031,16512,0,238,0,16512,940123,73488,0,0
3032,16732,0,220,0,16732,956855,73268,0,0
3033,16941,0,209,0,16941,973796,73059,0,0
3034,17173,0,232,0,17173,990969,72827,0,0
3035,17403,0,230,0,17403,1008372,72597,0,0
3036,17624,0,221,0,17624,1025996,72376,0,0
3037,17848,0,224,0,17848,1043844,72152,0,0
3038,18075,0,227,0,18075,1061919,71925,0,0
3039,18321,0,246,0,18321,1080240,71679,0,0
3040,18567,0,246,0,18567,1098807,71433,0,0
3041,18802,0,235,0,18802,1117609,71198,0,0
3042,19024,28566,222,594,18430,1108067,71570,0,0
3043,18683,3556,253,104,18579,1123194,71421,0,0
3044,18841,0,262,0,18841,1142035,71159,0,0
3045,19088,0,247,0,19088,1161123,70912,0,0
3046,19353,0,265,0,19353,1180476,70647,0,0
3047,19582,0,229,0,19582,1200058,70418,0,0
3048,19822,0,240,0,19822,1219880,70178,0,0
3049,20052,0,230,0,20052,1239932,69948,0,0
3050,20283,0,231,0,20283,1260215,69717,0,0
3051,20536,32366,253,644,19892,1248385,70108,0,0
3052,20119,15789,227,293,19826,1252715,70174,0,0
3053,20082,0,256,0,20082,1272797,69918,0,0
3054,20322,0,240,0,20322,1293119,69678,0,0
3055,20562,0,240,0,20562,1313681,69438,0,0
3056,20807,0,245,0,20807,1334488,69193,0,0
3057,21029,0,222,0,21029,1355517,68971,0,0
3058,21282,562943,253,6972,14310,813856,75690,0,0
3059,14497,0,187,0,14497,828353,75503,0,0
3060,14686,0,189,0,14686,843039,75314,0,0
3061,14902,0,216,0,14902,857941,75098,0,0
3062,15085,0,183,0,15085,873026,74915,0,0
3063,15286,0,201,0,15286,888312,74714,0,0
3064,15472,0,186,0,15472,903784,74528,0,0
3065,15676,0,204,0,15676,919460,74324,0,0
3066,15881,0,205,0,15881,935341,74119,0,0
3067,16102,0,221,0,16102,951443,73898,0,0
3068,16327,0,225,0,16327,967770,73673,0,0
3069,16557,0,230,0,16557,984327,73443,0,0
3070,16783,26920,226,488,16295,974190,73705,0,0
3071,16481,0,186,0,16481,990671,73519,0,0
3072,16707,0,226,0,16707,1007378,73293,0,0
3073,16916,0,209,0,16916,1024294,73084,0,0
3074,17131,320991,215,3600,13531,720434,76469,0,0
3075,13712,0,181,0,13712,734146,76288,0,0
3076,13914,0,202,0,13914,748060,76086,0,0
3077,14097,0,183,0,14097,762157,75903,0,0
3078,14310,0,213,0,14310,776467,75690,0,0
3079,14503,0,193,0,14503,790970,75497,0,0
3080,14693,0,190,0,14693,805663,75307,0,0
3081,14886,0,193,0,14886,820549,75114,0,0
3082,15088,33478,202,660,14428,802159,75572,0,0
3083,14630,29036,202,441,14189,787753,75811,0,0
3084,14422,0,233,0,14422,802175,75578,0,0
3085,14637,0,215,0,14637,816812,75363,0,0
3086,14816,13096,179,367,14449,818532,75551,0,0
3087,14632,0,183,0,14632,833164,75368,0,0
3088,14793,0,161,0,14793,847957,75207,0,0
3089,15009,107557,216,1743,13266,755409,76734,0,0
3090,13438,0,172,0,13438,768847,76562,0,0
3091,13603,0,165,0,13603,782450,76397,0,0
3092,13783,0,180,0,13783,796233,76217,0,0
3093,13957,0,174,0,13957,810190,76043,0,0
3094,14135,52536,178,807,13328,771789,76672,0,0
3095,13466,0,138,0,13466,785255,76534,0,0
3096,13642,0,176,0,13642,798897,76358,0,0
3097,13819,0,177,0,13819,812716,76181,0,0
3098,14004,14066,185,288,13716,812654,76284,0,0
3099,13908,0,192,0,13908,826562,76092,0,0
3100,14090,0,182,0,14090,840652,75910,0,0
3101,14281,0,191,0,14281,854933,75719,0,0
3102,14464,0,183,0,14464,869397,75536,0,0
3103,14639,0,175,0,14639,884036,75361,0,0
3104,14837,0,198,0,14837,898873,75163,0,0
3105,15031,113264,194,1716,13315,800640,76685,0,0
3106,13507,0,192,0,13507,814147,76493,0,0
3107,13651,0,144,0,13651,827798,76349,0,0
3108,13835,0,184,0,13835,841633,76165,0,0
3109,14004,0,169,0,14004,855637,75996,0,0
3110,14198,0,194,0,14198,869835,75802,0,0
3111,14392,0,194,0,14392,884227,75608,0,0
3112,14571,0,179,0,14571,898798,75429,0,0
3113,14746,0,175,0,14746,913544,75254,0,0
3114,14941,44763,195,699,14242,883722,75758,0,0
3115,14415,0,173,0,14415,898137,75585,0,0
3116,14614,0,199,0,14614,912751,75386,0,0
3117,14779,0,165,0,14779,927530,75221,0,0
3118,14962,0,183,0,14962,942492,75038,0,0
3119,15159,0,197,0,15159,957651,74841,0,0
3120,15337,0,178,0,15337,972988,74663,0,0
3121,15531,0,194,0,15531,988519,74469,0,0
3122,15694,0,163,0,15694,1004213,74306,0,0
3123,15895,0,201,0,15895,1020108,74105,0,0
3124,16075,0,180,0,16075,1036183,73925,0,0
3125,16250,0,175,0,16250,1052433,73750,0,0
3126,16461,0,211,0,16461,1068894,73539,0,0
3127,16658,28118,197,449,16209,1057434,73791,0,0
3128,16406,0,197,0,16406,1073840,73594,0,0
3129,16588,0,182,0,16588,1090428,73412,0,0
3130,16790,0,202,0,16790,1107218,73210,0,0
3131,16998,0,208,0,16998,1124216,73002,0,0
3132,17202,0,204,0,17202,1141418,72798,0,0
3133,17402,0,200,0,17402,1158820,72598,0,0
3134,17627,0,225,0,17627,1176447,72373,0,0
3135,17848,0,221,0,17848,1194295,72152,0,0
3136,18056,0,208,0,18056,1212351,71944,0,0
3137,18248,0,192,0,18248,1230599,71752,0,0
3138,18441,0,193,0,18441,1249040,71559,0,0
3139,18677,0,236,0,18677,1267717,71323,0,0
3140,18889,6227,212,173,18716,1280379,71284,0,0
3141,18937,0,221,0,18937,1299316,71063,0,0
3142,19178,0,241,0,19178,1318494,70822,0,0
3143,19375,181430,197,1761,17614,1156439,72386,0,0
3144,17806,141274,192,1900,15906,1032971,74094,0,0
3145,16108,0,202,0,16108,1049079,73892,0,0
3146,16305,0,197,0,16305,1065384,73695,0,0
3147,16481,0,176,0,16481,1081865,73519,0,0
3148,16666,0,185,0,16666,1098531,73334,0,0
3149,16873,0,207,0,16873,1115404,73127,0,0
3150,17093,693,220,36,17057,1131804,72943,0,0
3151,17246,0,189,0,17246,1149050,72754,0,0
3152,17440,372498,194,4182,13258,793992,76742,0,0
3153,13421,0,163,0,13421,807413,76579,0,0
3154,13586,0,165,0,13586,820999,76414,0,0
3155,13776,0,190,0,13776,834775,76224,0,0
3156,13942,8926,166,203,13739,839791,76261,0,0
3157,13952,0,213,0,13952,853743,76048,0,0
3158,14129,0,177,0,14129,867872,75871,0,0
3159,14299,0,170,0,14299,882171,75701,0,0
3160,14478,0,179,0,14478,896649,75522,0,0
3161,14680,0,202,0,14680,911329,75320,0,0
3162,14885,0,205,0,14885,926214,75115,0,0
3163,15070,0,185,0,15070,941284,74930,0,0
3164,15269,0,199,0,15269,956553,74731,0,0
3165,15459,0,190,0,15459,972012,74541,0,0
3166,15673,144542,214,1803,13870,843143,76130,0,0
3167,14081,0,211,0,14081,857224,75919,0,0
3168,14271,0,190,0,14271,871495,75729,0,0
3169,14476,0,205,0,14476,885971,75524,0,0
3170,14669,0,193,0,14669,900640,75331,0,0
3171,14864,0,195,0,14864,915504,75136,0,0
3172,15045,0,181,0,15045,930549,74955,0,0
3173,15246,0,201,0,15246,945795,74754,0,0
3174,15460,0,214,0,15460,961255,74540,0,0
3175,15661,0,201,0,15661,976916,74339,0,0
3176,15848,0,187,0,15848,992764,74152,0,0
3177,16050,0,202,0,16050,1008814,73950,0,0
3178,16243,0,193,0,16243,1025057,73757,0,0
3179,16419,0,176,0,16419,1041476,73581,0,0
3180,16625,26324,206,443,16182,1031777,73818,0,0
3181,16403,0,221,0,16403,1048180,73597,0,0
3182,16621,0,218,0,16621,1064801,73379,0,0
3183,16828,3,207,1,16827,1081626,73173,0,0
3184,17048,0,221,0,17048,1098674,72952,0,0
3185,17269,0,221,0,17269,1115943,72731,0,0
3186,17470,0,201,0,17470,1133413,72530,0,0
3187,17688,0,218,0,17688,1151101,72312,0,0
3188,17880,0,192,0,17880,1168981,72120,0,0
3189,18102,0,222,0,18102,1187083,71898,0,0
3190,18302,0,200,0,18302,1205385,71698,0,0
3191,18513,0,211,0,18513,1223898,71487,0,0
3192,18728,0,215,0,18728,1242626,71272,0,0
3193,18940,0,212,0,18940,1261566,71060,0,0
3194,19163,0,223,0,19163,1280729,70837,0,0
3195,19408,0,245,0,19408,1300137,70592,0,0
3196,19632,0,224,0,19632,1319769,70368,0,0
3197,19878,0,246,0,19878,1339647,70122,0,0
3198,20107,0,229,0,20107,1359754,69893,0,0
3199,20323,0,216,0,20323,1380077,69677,0,0
3200,20565,0,242,0,20565,1400642,69435,0,0
3201,20810,0,245,0,20810,1421452,69190,0,0
3202,21046,0,236,0,21046,1442498,68954,0,0
3203,21282,0,236,0,21282,1463780,68718,0,0
3204,21510,0,228,0,21510,1485290,68490,0,0
3205,21738,0,228,0,21738,1507028,68262,0,0
3206,21972,35087,234,702,21270,1493913,68730,0,0
3207,21505,0,235,0,21505,1515418,68495,0,0
3208,21701,0,196,0,21701,1537119,68299,0,0
3209,21934,408751,233,5086,16848,1150302,73152,0,0
3210,17028,75213,180,1001,16027,1092117,73973,0,0
3211,16188,0,161,0,16188,1108305,73812,0,0
3212,16360,0,172,0,16360,1124665,73640,0,0
3213,16558,0,198,0,16558,1141223,73442,0,0
3214,16737,0,179,0,16737,1157960,73263,0,0
3215,16928,158432,191,2205,14723,1016456,75277,0,0
3216,14905,206333,182,2393,12512,825028,77488,0,0
3217,12687,0,175,0,12687,837715,77313,0,0
3218,12845,0,158,0,12845,850560,77155,0,0
3219,12994,0,149,0,12994,863554,77006,0,0
3220,13147,0,153,0,13147,876701,76853,0,0
3221,13324,16007,177,363,12961,874018,77039,0,0
3222,13122,0,161,0,13122,887140,76878,0,0
3223,13255,0,133,0,13255,900395,76745,0,0
3224,13416,0,161,0,13416,913811,76584,0,0
3225,13611,0,195,0,13611,927422,76389,0,0
3226,13768,0,157,0,13768,941190,76232,0,0
3227,13913,0,145,0,13913,955103,76087,0,0
3228,14092,53742,179,867,13225,915453,76775,0,0
3229,13401,0,176,0,13401,928854,76599,0,0
3230,13558,0,157,0,13558,942412,76442,0,0
3231,13728,0,170,0,13728,956140,76272,0,0
3232,13888,0,160,0,13888,970028,76112,0,0
3233,14043,0,155,0,14043,984071,75957,0,0
3234,14229,0,186,0,14229,998300,75771,0,0
3235,14396,0,167,0,14396,1012696,75604,0,0
3236,14554,0,158,0,14554,1027250,75446,0,0
3237,14706,0,152,0,14706,1041956,75294,0,0
3238,14874,0,168,0,14874,1056830,75126,0,0
3239,15026,0,152,0,15026,1071856,74974,0,0
3240,15202,0,176,0,15202,1087058,74798,0,0
3241,15375,0,173,0,15375,1102433,74625,0,0
3242,15540,0,165,0,15540,1117973,74460,0,0
3243,15721,0,181,0,15721,1133694,74279,0,0
3244,15902,0,181,0,15902,1149596,74098,0,0
3245,16109,0,207,0,16109,1165705,73891,0,0
3246,16288,0,179,0,16288,1181993,73712,0,0
3247,16468,0,180,0,16468,1198461,73532,0,0
3248,16619,0,151,0,16619,1215080,73381,0,0
3249,16770,273915,151,2697,14073,957935,75927,0,0
3250,14248,0,175,0,14248,972183,75752,0,0
3251,14420,0,172,0,14420,986603,75580,0,0
3252,14590,0,170,0,14590,1001193,75410,0,0
3253,14770,0,180,0,14770,1015963,75230,0,0
3254,14939,0,169,0,14939,1030902,75061,0,0
3255,15125,0,186,0,15125,1046027,74875,0,0
3256,15317,0,192,0,15317,1061344,74683,0,0
3257,15508,0,191,0,15508,1076852,74492,0,0
3258,15679,0,171,0,15679,1092531,74321,0,0
3259,15862,0,183,0,15862,1108393,74138,0,0
3260,16051,0,189,0,16051,1124444,73949,0,0
3261,16229,0,178,0,16229,1140673,73771,0,0
3262,16399,0,170,0,16399,1157072,73601,0,0
3263,16590,0,191,0,16590,1173662,73410,0,0
3264,16776,73707,186,1078,15698,1116731,74302,0,0
3265,15876,0,178,0,15876,1132607,74124,0,0
3266,16073,130767,197,1442,14631,1017913,75369,0,0
3267,14801,0,170,0,14801,1032714,75199,0,0
3268,14991,452119,190,3997,10994,595586,79006,0,0
3269,11156,0,162,0,11156,606742,78844,0,0
3270,11326,0,170,0,11326,618068,78674,0,0
3271,11463,0,137,0,11463,629531,78537,0,0
3272,11629,0,166,0,11629,641160,78371,0,0
3273,11807,0,178,0,11807,652967,78193,0,0
3274,11976,0,169,0,11976,664943,78024,0,0
3275,12121,0,145,0,12121,677064,77879,0,0
3276,12296,0,175,0,12296,689360,77704,0,0
3277,12468,0,172,0,12468,701828,77532,0,0
3278,12629,0,161,0,12629,714457,77371,0,0
3279,12823,103855,194,1396,11427,623425,78573,0,0
3280,11596,0,169,0,11596,635021,78404,0,0
3281,11767,8723,171,212,11555,638065,78445,0,0
3282,11718,0,163,0,11718,649783,78282,0,0
3283,11874,1,156,1,11873,661656,78127,0,0
3284,12034,0,161,0,12034,673690,77966,0,0
3285,12195,0,161,0,12195,685885,77805,0,0
3286,12364,21078,169,291,12073,677171,77927,0,0
3287,12248,0,175,0,12248,689419,77752,0,0
3288,12418,0,170,0,12418,701837,77582,0,0
3289,12579,0,161,0,12579,714416,77421,0,0
3290,12760,0,181,0,12760,727176,77240,0,0
3291,12917,0,157,0,12917,740093,77083,0,0
3292,13105,0,188,0,13105,753198,76895,0,0
3293,13294,0,189,0,13294,766492,76706,0,0
3294,13462,0,168,0,13462,779954,76538,0,0
3295,13643,9365,181,244,13399,784232,76601,0,0
3296,13550,0,151,0,13550,797782,76450,0,0
3297,13753,0,203,0,13753,811535,76247,0,0
3298,13952,0,199,0,13952,825487,76048,0,0
3299,14131,0,179,0,14131,839618,75869,0,0
3300,14316,0,185,0,14316,853934,75684,0,0
3301,14528,0,212,0,14528,868462,75472,0,0
3302,14745,0,217,0,14745,883207,75255,0,0
3303,14945,0,200,0,14945,898152,75055,0,0
3304,15149,0,204,0,15149,913301,74851,0,0
3305,15324,5696,175,169,15155,922929,74845,0,0
3306,15343,0,188,0,15343,938272,74657,0,0
3307,15538,0,195,0,15538,953810,74462,0,0
3308,15735,52792,197,727,15008,916753,74992,0,0
3309,15192,0,184,0,15192,931945,74808,0,0
3310,15384,0,192,0,15384,947329,74616,0,0
3311,15598,0,214,0,15598,962927,74402,0,0
3312,15794,0,196,0,15794,978721,74206,0,0
3313,15990,0,196,0,15990,994711,74010,0,0
3314,16222,0,232,0,16222,1010933,73778,0,0
3315,16430,0,208,0,16430,1027363,73570,0,0
3316,16618,0,188,0,16618,1043981,73382,0,0
3317,16849,0,231,0,16849,1060830,73151,0,0
3318,17063,0,214,0,17063,1077893,72937,0,0
3319,17281,0,218,0,17281,1095174,72719,0,0
3320,17484,0,203,0,17484,1112658,72516,0,0
3321,17703,58936,219,641,17062,1071425,72938,0,0
3322,17289,0,227,0,17289,1088714,72711,0,0
3323,17516,0,227,0,17516,1106230,72484,0,0
3324,17752,0,236,0,17752,1123982,72248,0,0
3325,17956,0,204,0,17956,1141938,72044,0,0
3326,18175,0,219,0,18175,1160113,71825,0,0
3327,18404,0,229,0,18404,1178517,71596,0,0
3328,18637,0,233,0,18637,1197154,71363,0,0
3329,18889,0,252,0,18889,1216043,71111,0,0
3330,19106,0,217,0,19106,1235149,70894,0,0
3331,19314,111194,208,1352,17962,1143269,72038,0,0
3332,18177,0,215,0,18177,1161446,71823,0,0
3333,18420,0,243,0,18420,1179866,71580,0,0
3334,18659,53594,239,565,18094,1144931,71906,0,0
3335,18327,179557,233,1829,16498,983701,73502,0,0
3336,16723,0,225,0,16723,1000424,73277,0,0
3337,16926,0,203,0,16926,1017350,73074,0,0
3338,17149,0,223,0,17149,1034499,72851,0,0
3339,17372,0,223,0,17372,1051871,72628,0,0
3340,17620,0,248,0,17620,1069491,72380,0,0
3341,17844,0,224,0,17844,1087335,72156,0,0
3342,18087,0,243,0,18087,1105422,71913,0,0
3343,18283,0,196,0,18283,1123705,71717,0,0
3344,18519,0,236,0,18519,1142224,71481,0,0
3345,18743,0,224,0,18743,1160967,71257,0,0
3346,18968,0,225,0,18968,1179935,71032,0,0
3347,19215,0,247,0,19215,1199150,70785,0,0
3348,19457,0,242,0,19457,1218607,70543,0,0
3349,19648,0,191,0,19648,1238255,70352,0,0
3350,19863,0,215,0,19863,1258118,70137,0,0
3351,20103,0,240,0,20103,1278221,69897,0,0
3352,20326,885,223,44,20282,1297662,69718,0,0
3353,20523,0,241,0,20523,1318185,69477,0,0
3354,20777,0,254,0,20777,1338962,69223,0,0
3355,21040,465828,263,6531,14509,894174,75491,0,0
3356,14713,0,204,0,14713,908887,75287,0,0
3357,14915,230226,202,2715,12200,693576,77800,0,0
3358,12374,0,174,0,12374,705950,77626,0,0
3359,12558,58468,184,729,11829,660040,78171,0,0
3360,11997,0,168,0,11997,672037,78003,0,0
3361,12165,0,168,0,12165,684202,77835,0,0
3362,12351,0,186,0,12351,696553,77649,0,0
3363,12532,0,181,0,12532,709085,77468,0,0
3364,12724,0,192,0,12724,721809,77276,0,0
3365,12885,0,161,0,12885,734694,77115,0,0
3366,13076,0,191,0,13076,747770,76924,0,0
3367,13271,0,195,0,13271,761041,76729,0,0
3368,13459,0,188,0,13459,774500,76541,0,0
3369,13659,224063,200,2871,10788,564096,79212,0,0
3370,10945,0,157,0,10945,575041,79055,0,0
3371,11116,0,171,0,11116,586157,78884,0,0
3372,11286,0,170,0,11286,597443,78714,0,0
3373,11463,0,177,0,11463,608906,78537,0,0
3374,11643,0,180,0,11643,620549,78357,0,0
3375,11834,0,191,0,11834,632383,78166,0,0
3376,12003,0,169,0,12003,644386,77997,0,0
3377,12183,0,180,0,12183,656569,77817,0,0
3378,12388,0,205,0,12388,668957,77612,0,0
3379,12587,0,199,0,12587,681544,77413,0,0
3380,12778,0,191,0,12778,694322,77222,0,0
3381,12983,0,205,0,12983,707305,77017,0,0
3382,13184,0,201,0,13184,720489,76816,0,0
3383,13389,0,205,0,13389,733878,76611,0,0
3384,13578,0,189,0,13578,747456,76422,0,0
3385,13772,0,194,0,13772,761228,76228,0,0
3386,14000,49441,228,952,13048,725787,76952,0,0
3387,13235,0,187,0,13235,739022,76765,0,0
3388,13439,0,204,0,13439,752461,76561,0,0
3389,13628,0,189,0,13628,766089,76372,0,0
3390,13789,0,161,0,13789,779878,76211,0,0
3391,13977,0,188,0,13977,793855,76023,0,0
3392,14164,0,187,0,14164,808019,75836,0,0
3393,14359,0,195,0,14359,822378,75641,0,0
3394,14575,0,216,0,14575,836953,75425,0,0
3395,14787,3333,212,96,14691,848407,75309,0,0
3396,14885,0,194,0,14885,863292,75115,0,0
3397,15063,0,178,0,15063,878355,74937,0,0
3398,15274,0,211,0,15274,893629,74726,0,0
3399,15478,0,204,0,15478,909107,74522,0,0
3400,15705,0,227,0,15705,924812,74295,0,0
3401,15905,0,200,0,15905,940717,74095,0,0
3402,16125,17489,220,326,15799,939353,74201,0,0
3403,16006,0,207,0,16006,955359,73994,0,0
3404,16233,0,227,0,16233,971592,73767,0,0
3405,16424,0,191,0,16424,988016,73576,0,0
3406,16661,0,237,0,16661,1004677,73339,0,0
3407,16899,0,238,0,16899,1021576,73101,0,0
3408,17131,0,232,0,17131,1038707,72869,0,0
3409,17358,0,227,0,17358,1056065,72642,0,0
3410,17571,0,213,0,17571,1073636,72429,0,0
3411,17808,0,237,0,17808,1091444,72192,0,0
3412,18031,0,223,0,18031,1109475,71969,0,0
3413,18257,0,226,0,18257,1127732,71743,0,0
3414,18509,0,252,0,18509,1146241,71491,0,0
3415,18740,0,231,0,18740,1164981,71260,0,0
3416,18985,0,245,0,18985,1183966,71015,0,0
3417,19226,0,241,0,19226,1203192,70774,0,0
3418,19457,0,231,0,19457,1222649,70543,0,0
3419,19703,0,246,0,19703,1242352,70297,0,0
3420,19932,0,229,0,19932,1262284,70068,0,0
3421,20171,0,239,0,20171,1282455,69829,0,0
3422,20409,23711,238,550,19859,1279153,70141,0,0
3423,20103,0,244,0,20103,1299256,69897,0,0
3424,20363,0,260,0,20363,1319619,69637,0,0
3425,20613,259114,250,3029,17584,1081118,72416,0,0
3426,17785,0,201,0,17785,1098903,72215,0,0
3427,18000,75089,215,802,17198,1041814,72802,0,0
3428,17401,0,203,0,17401,1059215,72599,0,0
3429,17594,22786,193,437,17157,1054023,72843,0,0
3430,17366,0,209,0,17366,1071389,72634,0,0
3431,17582,8501,216,179,17403,1080470,72597,0,0
3432,17634,0,231,0,17634,1098104,72366,0,0
3433,17854,0,220,0,17854,1115958,72146,0,0
3434,18081,0,227,0,18081,1134039,71919,0,0
3435,18296,0,215,0,18296,1152335,71704,0,0
3436,18509,100332,213,1669,16840,1070512,73160,0,0
3437,17066,0,226,0,17066,1087578,72934,0,0
3438,17263,0,197,0,17263,1104841,72737,0,0
3439,17435,0,172,0,17435,1122276,72565,0,0
3440,17659,42302,224,615,17044,1097633,72956,0,0
3441,17242,0,198,0,17242,1114875,72758,0,0
3442,17459,0,217,0,17459,1132334,72541,0,0
3443,17656,0,197,0,17656,1149990,72344,0,0
3444,17883,0,227,0,17883,1167873,72117,0,0
3445,18089,0,206,0,18089,1185962,71911,0,0
3446,18280,0,191,0,18280,1204242,71720,0,0
3447,18485,0,205,0,18485,1222727,71515,0,0
3448,18704,0,219,0,18704,1241431,71296,0,0
3449,18916,0,212,0,18916,1260347,71084,0,0
3450,19119,247862,203,2793,16326,1031604,73674,0,0
3451,16531,0,205,0,16531,1048135,73469,0,0
3452,16715,0,184,0,16715,1064850,73285,0,0
3453,16934,0,219,0,16934,1081784,73066,0,0
3454,17124,0,190,0,17124,1098908,72876,0,0
3455,17307,0,183,0,17307,1116215,72693,0,0
3456,17522,0,215,0,17522,1133737,72478,0,0
3457,17735,0,213,0,17735,1151472,72265,0,0
3458,17957,5427,222,122,17835,1164002,72165,0,0
3459,18031,0,196,0,18031,1182033,71969,0,0
3460,18236,0,205,0,18236,1200269,71764,0,0
3461,18454,0,218,0,18454,1218723,71546,0,0
3462,18654,0,200,0,18654,1237377,71346,0,0
3463,18838,294763,184,3353,15485,961452,74515,0,0
3464,15674,0,189,0,15674,977126,74326,0,0
3465,15864,0,190,0,15864,992990,74136,0,0
3466,16050,0,186,0,16050,1009040,73950,0,0
3467,16256,0,206,0,16256,1025296,73744,0,0
3468,16427,0,171,0,16427,1041723,73573,0,0
3469,16627,0,200,0,16627,1058350,73373,0,0
3470,16792,0,165,0,16792,1075142,73208,0,0
3471,16990,0,198,0,16990,1092132,73010,0,0
3472,17175,0,185,0,17175,1109307,72825,0,0
3473,17356,0,181,0,17356,1126663,72644,0,0
3474,17547,0,191,0,17547,1144210,72453,0,0
3475,17742,0,195,0,17742,1161952,72258,0,0
3476,17962,71039,220,740,17222,1108875,72778,0,0
3477,17420,0,198,0,17420,1126295,72580,0,0
3478,17616,0,196,0,17616,1143911,72384,0,0
3479,17836,0,220,0,17836,1161747,72164,0,0
3480,18053,0,217,0,18053,1179800,71947,0,0
3481,18265,0,212,0,18265,1198065,71735,0,0
3482,18480,0,215,0,18480,1216545,71520,0,0
3483,18681,0,201,0,18681,1235226,71319,0,0
3484,18905,0,224,0,18905,1254131,71095,0,0
3485,19105,0,200,0,19105,1273236,70895,0,0
3486,19336,0,231,0,19336,1292572,70664,0,0
3487,19542,0,206,0,19542,1312114,70458,0,0
3488,19770,0,228,0,19770,1331884,70230,0,0
3489,19966,0,196,0,19966,1351850,70034,0,0
3490,20188,144434,222,2399,17789,1227604,72211,0,0
3491,17986,0,197,0,17986,1245590,72014,0,0
3492,18186,0,200,0,18186,1263776,71814,0,0
3493,18390,0,204,0,18390,1282166,71610,0,0
3494,18575,0,185,0,18575,1300741,71425,0,0
3495,18747,0,172,0,18747,1319488,71253,0,0
3496,18940,86429,193,1071,17869,1251999,72131,0,0
3497,18038,0,169,0,18038,1270037,71962,0,0
3498,18216,0,178,0,18216,1288253,71784,0,0
3499,18412,465097,196,5117,13295,841568,76705,0,0
3500,13457,0,162,0,13457,855025,76543,0,0
3501,13620,0,163,0,13620,868645,76380,0,0
3502,13797,0,177,0,13797,882442,76203,0,0
3503,13958,0,161,0,13958,896400,76042,0,0
3504,14133,0,175,0,14133,910533,75867,0,0
3505,14283,0,150,0,14283,924816,75717,0,0
3506,14449,37612,166,484,13965,901653,76035,0,0
3507,14137,0,172,0,14137,915790,75863,0,0
3508,14305,4,168,1,14304,930091,75696,0,0
3509,14485,0,181,0,14485,944576,75515,0,0
3510,14658,0,173,0,14658,959234,75342,0,0
3511,14830,0,172,0,14830,974064,75170,0,0
3512,15000,323781,170,3826,11174,665283,78826,0,0
3513,11314,0,140,0,11314,676597,78686,0,0
3514,11474,0,160,0,11474,688071,78526,0,0
3515,11613,0,139,0,11613,699684,78387,0,0
3516,11774,0,161,0,11774,711458,78226,0,0
3517,11942,0,168,0,11942,723400,78058,0,0
3518,12093,0,151,0,12093,735493,77907,0,0
3519,12256,0,163,0,12256,747749,77744,0,0
3520,12436,912,180,39,12397,759273,77603,0,0
3521,12556,0,159,0,12556,771829,77444,0,0
3522,12738,0,182,0,12738,784567,77262,0,0
3523,12885,0,147,0,12885,797452,77115,0,0
3524,13038,0,153,0,13038,810490,76962,0,0
3525,13210,0,172,0,13210,823700,76790,0,0
3526,13375,0,165,0,13375,837075,76625,0,0
3527,13540,0,165,0,13540,850615,76460,0,0
3528,13703,204690,163,2132,11571,659628,78429,0,0
3529,11742,138163,171,1614,10128,533207,79872,0,0
3530,10298,0,170,0,10298,543505,79702,0,0
3531,10457,0,159,0,10457,553962,79543,0,0
3532,10626,0,169,0,10626,564588,79374,0,0
3533,10791,0,165,0,10791,575379,79209,0,0
3534,10927,0,136,0,10927,586306,79073,0,0
3535,11090,0,163,0,11090,597396,78910,0,0
3536,11263,50922,173,688,10575,557737,79425,0,0
3537,10734,0,159,0,10734,568471,79266,0,0
3538,10880,0,146,0,10880,579351,79120,0,0
3539,11045,0,165,0,11045,590396,78955,0,0
3540,11218,0,173,0,11218,601614,78782,0,0
3541,11378,0,160,0,11378,612992,78622,0,0
3542,11542,0,164,0,11542,624534,78458,0,0
3543,11696,0,154,0,11696,636230,78304,0,0
3544,11884,12652,188,256,11628,635462,78372,0,0
3545,11785,0,157,0,11785,647247,78215,0,0
3546,11921,0,136,0,11921,659168,78079,0,0
3547,12094,16053,173,339,11755,655209,78245,0,0
3548,11939,73914,184,913,11026,593234,78974,0,0
3549,11179,0,153,0,11179,604413,78821,0,0
3550,11335,0,156,0,11335,615748,78665,0,0
3551,11503,36299,168,652,10851,590952,79149,0,0
3552,10996,0,145,0,10996,601948,79004,0,0
3553,11145,0,149,0,11145,613093,78855,0,0
3554,11311,0,166,0,11311,624404,78689,0,0
3555,11467,0,156,0,11467,635871,78533,0,0
3556,11652,0,185,0,11652,647523,78348,0,0
3557,11817,0,165,0,11817,659340,78183,0,0
3558,11989,0,172,0,11989,671329,78011,0,0
3559,12168,0,179,0,12168,683497,77832,0,0
3560,12344,0,176,0,12344,695841,77656,0,0
3561,12493,14979,149,286,12207,693355,77793,0,0
3562,12378,0,171,0,12378,705733,77622,0,0
3563,12549,0,171,0,12549,718282,77451,0,0
3564,12734,58719,185,925,11809,672297,78191,0,0
3565,11966,0,157,0,11966,684263,78034,0,0
3566,12149,0,183,0,12149,696412,77851,0,0
3567,12333,74903,184,1040,11293,633842,78707,0,0
3568,11455,0,162,0,11455,645297,78545,0,0
3569,11663,0,208,0,11663,656960,78337,0,0
3570,11828,1032,165,42,11786,667756,78214,0,0
3571,11945,0,159,0,11945,679701,78055,0,0
3572,12111,22380,166,398,11713,669432,78287,0,0
3573,11887,0,174,0,11887,681319,78113,0,0
3574,12052,0,165,0,12052,693371,77948,0,0
3575,12207,0,155,0,12207,705578,77793,0,0
3576,12351,0,144,0,12351,717929,77649,0,0
3577,12512,79767,161,1119,11393,650674,78607,0,0
3578,11566,0,173,0,11566,662240,78434,0,0
3579,11724,6707,158,182,11542,667257,78458,0,0
3580,11708,0,166,0,11708,678965,78292,0,0
3581,11864,0,156,0,11864,690829,78136,0,0
3582,12069,0,205,0,12069,702898,77931,0,0
3583,12256,0,187,0,12256,715154,77744,0,0
3584,12414,204406,158,2613,9801,523162,80199,0,0
3585,9944,0,143,0,9944,533106,80056,0,0
3586,10121,0,177,0,10121,543227,79879,0,0
3587,10273,0,152,0,10273,553500,79727,0,0
3588,10434,0,161,0,10434,563934,79566,0,0
3589,10596,0,162,0,10596,574530,79404,0,0
3590,10749,0,153,0,10749,585279,79251,0,0
3591,10940,0,191,0,10940,596219,79060,0,0
3592,11106,0,166,0,11106,607325,78894,0,0
3593,11282,6657,176,173,11109,611950,78891,0,0
3594,11293,0,184,0,11293,623243,78707,0,0
3595,11464,0,171,0,11464,634707,78536,0,0
3596,11637,0,173,0,11637,646344,78363,0,0
3597,11809,0,172,0,11809,658153,78191,0,0
3598,11975,0,166,0,11975,670128,78025,0,0
3599,12172,6589,197,219,11953,675711,78047,0,0
3600,12144,0,191,0,12144,687855,77856,0,0
3601,12308,6325,164,150,12158,693838,77842,0,0
3602,12357,66368,199,1144,11213,639827,78787,0,0
3603,11379,0,166,0,11379,651206,78621,0,0
3604,11538,0,159,0,11538,662744,78462,0,0
3605,11718,0,180,0,11718,674462,78282,0,0
3606,11899,0,181,0,11899,686361,78101,0,0
3607,12069,0,170,0,12069,698430,77931,0,0
3608,12243,98413,174,1414,10829,612260,79171,0,0
3609,10977,0,148,0,10977,623237,79023,0,0
3610,11131,0,154,0,11131,634368,78869,0,0
3611,11285,0,154,0,11285,645653,78715,0,0
3612,11462,0,177,0,11462,657115,78538,0,0
3613,11653,0,191,0,11653,668768,78347,0,0
3614,11820,0,167,0,11820,680588,78180,0,0
3615,11995,0,175,0,11995,692583,78005,0,0
3616,12159,0,164,0,12159,704742,77841,0,0
3617,12336,0,177,0,12336,717078,77664,0,0
3618,12511,0,175,0,12511,729589,77489,0,0
3619,12709,0,198,0,12709,742298,77291,0,0
3620,12884,0,175,0,12884,755182,77116,0,0
3621,13042,0,158,0,13042,768224,76958,0,0
3622,13219,0,177,0,13219,781443,76781,0,0
3623,13405,0,186,0,13405,794848,76595,0,0
3624,13583,0,178,0,13583,808431,76417,0,0
3625,13785,0,202,0,13785,822216,76215,0,0
3626,13968,0,183,0,13968,836184,76032,0,0
3627,14175,0,207,0,14175,850359,75825,0,0
3628,14371,224075,196,2869,11502,640655,78498,0,0
3629,11674,0,172,0,11674,652329,78326,0,0
3630,11841,0,167,0,11841,664170,78159,0,0
3631,12010,0,169,0,12010,676180,77990,0,0
3632,12182,0,172,0,12182,688362,77818,0,0
3633,12345,0,163,0,12345,700707,77655,0,0
3634,12528,0,183,0,12528,713235,77472,0,0
3635,12713,0,185,0,12713,725948,77287,0,0
3636,12874,0,161,0,12874,738822,77126,0,0
3637,13060,0,186,0,13060,751882,76940,0,0
3638,13248,0,188,0,13248,765130,76752,0,0
3639,13430,0,182,0,13430,778560,76570,0,0
3640,13603,0,173,0,13603,792163,76397,0,0
3641,13814,0,211,0,13814,805977,76186,0,0
3642,14013,0,199,0,14013,819990,75987,0,0
3643,14208,0,195,0,14208,834198,75792,0,0
3644,14426,0,218,0,14426,848624,75574,0,0
3645,14648,0,222,0,14648,863272,75352,0,0
3646,14839,0,191,0,14839,878111,75161,0,0
3647,15038,0,199,0,15038,893149,74962,0,0
3648,15231,0,193,0,15231,908380,74769,0,0
3649,15451,83060,220,946,14505,840771,75495,0,0
3650,14699,61313,194,971,13728,794157,76272,0,0
3651,13919,0,191,0,13919,808076,76081,0,0
3652,14106,0,187,0,14106,822182,75894,0,0
3653,14291,0,185,0,14291,836473,75709,0,0
3654,14492,0,201,0,14492,850965,75508,0,0
3655,14702,0,210,0,14702,865667,75298,0,0
3656,14907,0,205,0,14907,880574,75093,0,0
3657,15096,0,189,0,15096,895670,74904,0,0
3658,15294,0,198,0,15294,910964,74706,0,0
3659,15482,0,188,0,15482,926446,74518,0,0
3660,15689,0,207,0,15689,942135,74311,0,0
3661,15882,0,193,0,15882,958017,74118,0,0
3662,16089,202459,207,2981,13108,771647,76892,0,0
3663,13271,0,163,0,13271,784918,76729,0,0
3664,13474,98919,203,1518,11956,699473,78044,0,0
3665,12114,0,158,0,12114,711587,77886,0,0
3666,12298,907,184,37,12261,722978,77739,0,0
3667,12432,0,171,0,12432,735410,77568,0,0
3668,12605,0,173,0,12605,748015,77395,0,0
3669,12784,0,179,0,12784,760799,77216,0,0
3670,12951,0,167,0,12951,773750,77049,0,0
3671,13154,0,203,0,13154,786904,76846,0,0
3672,13330,0,176,0,13330,800234,76670,0,0
3673,13520,0,190,0,13520,813754,76480,0,0
3674,13703,0,183,0,13703,827457,76297,0,0
3675,13884,0,181,0,13884,841341,76116,0,0
3676,14075,0,191,0,14075,855416,75925,0,0
3677,14274,240451,199,2320,11954,629239,78046,0,0
3678,12115,0,161,0,12115,641354,77885,0,0
3679,12270,0,155,0,12270,653624,77730,0,0
3680,12450,0,180,0,12450,666074,77550,0,0
3681,12618,0,168,0,12618,678692,77382,0,0
3682,12813,0,195,0,12813,691505,77187,0,0
3683,12984,0,171,0,12984,704489,77016,0,0
3684,13154,0,170,0,13154,717643,76846,0,0
3685,13319,0,165,0,13319,730962,76681,0,0
3686,13498,0,179,0,13498,744460,76502,0,0
3687,13683,55679,185,1020,12663,702464,77337,0,0
3688,12825,0,162,0,12825,715289,77175,0,0
3689,13002,0,177,0,13002,728291,76998,0,0
3690,13208,0,206,0,13208,741499,76792,0,0
3691,13391,0,183,0,13391,754890,76609,0,0
3692,13588,0,197,0,13588,768478,76412,0,0
3693,13780,0,192,0,13780,782258,76220,0,0
3694,13980,0,200,0,13980,796238,76020,0,0
3695,14156,0,176,0,14156,810394,75844,0,0
3696,14360,0,204,0,14360,824754,75640,0,0
3697,14543,0,183,0,14543,839297,75457,0,0
3698,14732,0,189,0,14732,854029,75268,0,0
3699,14945,0,213,0,14945,868974,75055,0,0
3700,15143,0,198,0,15143,884117,74857,0,0
3701,15336,0,193,0,15336,899453,74664,0,0
3702,15529,0,193,0,15529,914982,74471,0,0
3703,15733,0,204,0,15733,930715,74267,0,0
3704,15940,0,207,0,15940,946655,74060,0,0
3705,16158,0,218,0,16158,962813,73842,0,0
3706,16366,0,208,0,16366,979179,73634,0,0
3707,16555,0,189,0,16555,995734,73445,0,0
3708,16771,0,216,0,16771,1012505,73229,0,0
3709,16969,0,198,0,16969,1029474,73031,0,0
3710,17188,215187,219,3347,13841,831475,76159,0,0
3711,14013,0,172,0,14013,845488,75987,0,0
3712,14204,0,191,0,14204,859692,75796,0,0
3713,14384,0,180,0,14384,874076,75616,0,0
3714,14567,0,183,0,14567,888643,75433,0,0
3715,14762,10982,195,192,14570,892423,75430,0,0
3716,14758,0,188,0,14758,907181,75242,0,0
3717,14955,0,197,0,14955,922136,75045,0,0
3718,15129,0,174,0,15129,937265,74871,0,0
3719,15335,0,206,0,15335,952600,74665,0,0
3720,15543,39406,208,543,15000,928737,75000,0,0
3721,15208,0,208,0,15208,943945,74792,0,0
3722,15411,0,203,0,15411,959356,74589,0,0
3723,15607,0,196,0,15607,974963,74393,0,0
3724,15803,0,196,0,15803,990766,74197,0,0
3725,15979,0,176,0,15979,1006745,74021,0,0
3726,16165,0,186,0,16165,1022910,73835,0,0
3727,16358,0,193,0,16358,1039268,73642,0,0
3728,16588,0,230,0,16588,1055856,73412,0,0
3729,16822,0,234,0,16822,1072678,73178,0,0
3730,17030,51137,208,667,16363,1038571,73637,0,0
3731,16547,0,184,0,16547,1055118,73453,0,0
3732,16750,0,203,0,16750,1071868,73250,0,0
3733,16937,0,187,0,16937,1088805,73063,0,0
3734,17150,243821,213,3614,13536,862134,76464,0,0
3735,13713,0,177,0,13713,875847,76287,0,0
3736,13873,0,160,0,13873,889720,76127,0,0
3737,14041,0,168,0,14041,903761,75959,0,0
3738,14216,0,175,0,14216,917977,75784,0,0
3739,14400,0,184,0,14400,932377,75600,0,0
3740,14577,149697,177,2033,12544,797257,77456,0,0
3741,12721,0,177,0,12721,809978,77279,0,0
3742,12877,0,156,0,12877,822855,77123,0,0
3743,13043,0,166,0,13043,835898,76957,0,0
3744,13216,0,173,0,13216,849114,76784,0,0
3745,13379,0,163,0,13379,862493,76621,0,0
3746,13567,15427,188,290,13277,860633,76723,0,0
3747,13430,0,153,0,13430,874063,76570,0,0
3748,13620,0,190,0,13620,887683,76380,0,0
3749,13781,0,161,0,13781,901464,76219,0,0
3750,13979,0,198,0,13979,915443,76021,0,0
3751,14182,0,203,0,14182,929625,75818,0,0
3752,14360,0,178,0,14360,943985,75640,0,0
3753,14569,0,209,0,14569,958554,75431,0,0
3754,14757,0,188,0,14757,973311,75243,0,0
3755,14958,0,201,0,14958,988269,75042,0,0
3756,15153,0,195,0,15153,1003422,74847,0,0
3757,15361,0,208,0,15361,1018783,74639,0,0
3758,15550,88358,189,1349,14201,945975,75799,0,0
3759,14393,0,192,0,14393,960368,75607,0,0
3760,14591,0,198,0,14591,974959,75409,0,0
3761,14769,0,178,0,14769,989728,75231,0,0
3762,14961,4980,192,158,14803,999709,75197,0,0
3763,14975,0,172,0,14975,1014684,75025,0,0
3764,15168,0,193,0,15168,1029852,74832,0,0
3765,15373,0,205,0,15373,1045225,74627,0,0
3766,15570,0,197,0,15570,1060795,74430,0,0
3767,15781,0,211,0,15781,1076576,74219,0,0
3768,15979,0,198,0,15979,1092555,74021,0,0
3769,16176,0,197,0,16176,1108731,73824,0,0
3770,16368,513272,192,4955,11413,611827,78587,0,0
3771,11587,0,174,0,11587,623414,78413,0,0
3772,11773,0,186,0,11773,635187,78227,0,0
3773,11934,0,161,0,11934,647121,78066,0,0
3774,12114,0,180,0,12114,659235,77886,0,0
3775,12302,805,188,38,12264,670732,77736,0,0
3776,12439,0,175,0,12439,683171,77561,0,0
3777,12624,0,185,0,12624,695795,77376,0,0
3778,12833,0,209,0,12833,708628,77167,0,0
3779,13020,0,187,0,13020,721648,76980,0,0
3780,13197,0,177,0,13197,734845,76803,0,0
3781,13374,1087,177,45,13329,747132,76671,0,0
3782,13520,0,191,0,13520,760652,76480,0,0
3783,13712,0,192,0,13712,774364,76288,0,0
3784,13883,0,171,0,13883,788247,76117,0,0
3785,14068,0,185,0,14068,802315,75932,0,0
3786,14249,0,181,0,14249,816564,75751,0,0
3787,14455,0,206,0,14455,831019,75545,0,0
3788,14653,0,198,0,14653,845672,75347,0,0
3789,14874,109312,221,1545,13329,751234,76671,0,0
3790,13511,0,182,0,13511,764745,76489,0,0
3791,13698,0,187,0,13698,778443,76302,0,0
3792,13894,0,196,0,13894,792337,76106,0,0
3793,14105,0,211,0,14105,806442,75895,0,0
3794,14299,0,194,0,14299,820741,75701,0,0
3795,14481,0,182,0,14481,835222,75519,0,0
3796,14680,0,199,0,14680,849902,75320,0,0
3797,14891,57250,211,1065,13826,807543,76174,0,0
3798,14005,0,179,0,14005,821548,75995,0,0
3799,14191,0,186,0,14191,835739,75809,0,0
3800,14361,0,170,0,14361,850100,75639,0,0
3801,14536,0,175,0,14536,864636,75464,0,0
3802,14748,0,212,0,14748,879384,75252,0,0
3803,14964,0,216,0,14964,894348,75036,0,0
3804,15141,0,177,0,15141,909489,74859,0,0
3805,15359,0,218,0,15359,924848,74641,0,0
3806,15548,0,189,0,15548,940396,74452,0,0
3807,15746,0,198,0,15746,956142,74254,0,0
3808,15943,0,197,0,15943,972085,74057,0,0
3809,16163,0,220,0,16163,988248,73837,0,0
3810,16384,0,221,0,16384,1004632,73616,0,0
3811,16600,0,216,0,16600,1021232,73400,0,0
3812,16814,0,214,0,16814,1038046,73186,0,0
3813,17027,0,213,0,17027,1055073,72973,0,0
3814,17230,38118,203,634,16596,1034185,73404,0,0
3815,16793,0,197,0,16793,1050978,73207,0,0
3816,16997,0,204,0,16997,1067975,73003,0,0
3817,17183,0,186,0,17183,1085158,72817,0,0
3818,17408,0,225,0,17408,1102566,72592,0,0
3819,17627,0,219,0,17627,1120193,72373,0,0
3820,17873,0,246,0,17873,1138066,72127,0,0
3821,18068,107852,195,1213,16855,1048282,73145,0,0
3822,17054,0,199,0,17054,1065336,72946,0,0
3823,17261,0,207,0,17261,1082597,72739,0,0
3824,17487,0,226,0,17487,1100084,72513,0,0
3825,17711,18161,224,320,17391,1099634,72609,0,0
3826,17592,125250,201,1782,15810,991976,74190,0,0
3827,16007,0,197,0,16007,1007983,73993,0,0
3828,16241,0,234,0,16241,1024224,73759,0,0
3829,16460,0,219,0,16460,1040684,73540,0,0
3830,16648,0,188,0,16648,1057332,73352,0,0
3831,16849,54529,201,815,16034,1019652,73966,0,0
3832,16268,0,234,0,16268,1035920,73732,0,0
3833,16461,159227,193,1497,14964,893154,75036,0,0
3834,15184,0,220,0,15184,908338,74816,0,0
3835,15374,0,190,0,15374,923712,74626,0,0
3836,15585,23132,211,475,15110,916165,74890,0,0
3837,15293,0,183,0,15293,931458,74707,0,0
3838,15505,50085,212,710,14795,896878,75205,0,0
3839,14981,0,186,0,14981,911859,75019,0,0
3840,15186,0,205,0,15186,927045,74814,0,0
3841,15380,0,194,0,15380,942425,74620,0,0
3842,15551,0,171,0,15551,957976,74449,0,0
3843,15763,0,212,0,15763,973739,74237,0,0
3844,15972,0,209,0,15972,989711,74028,0,0
3845,16153,0,181,0,16153,1005864,73847,0,0
3846,16345,0,192,0,16345,1022209,73655,0,0
3847,16554,0,209,0,16554,1038763,73446,0,0
3848,16759,0,205,0,16759,1055522,73241,0,0
3849,16985,0,226,0,16985,1072507,73015,0,0
3850,17192,1383,207,63,17129,1088316,72871,0,0
3851,17340,0,211,0,17340,1105656,72660,0,0
3852,17565,0,225,0,17565,1123221,72435,0,0
3853,17764,0,199,0,17764,1140985,72236,0,0
3854,17964,0,200,0,17964,1158949,72036,0,0
3855,18156,0,192,0,18156,1177105,71844,0,0
3856,18374,0,218,0,18374,1195479,71626,0,0
3857,18591,0,217,0,18591,1214070,71409,0,0
3858,18779,31424,188,347,18432,1201425,71568,0,0
3859,18642,0,210,0,18642,1220067,71358,0,0
3860,18877,0,235,0,18877,1238944,71123,0,0
3861,19082,0,205,0,19082,1258026,70918,0,0
3862,19294,0,212,0,19294,1277320,70706,0,0
3863,19535,0,241,0,19535,1296855,70465,0,0
3864,19775,0,240,0,19775,1316630,70225,0,0
3865,19989,0,214,0,19989,1336619,70011,0,0
3866,20211,0,222,0,20211,1356830,69789,0,0
3867,20468,0,257,0,20468,1377298,69532,0,0
3868,20686,0,218,0,20686,1397984,69314,0,0
3869,20912,288749,226,2932,17980,1130147,72020,0,0
3870,18202,0,222,0,18202,1148349,71798,0,0
3871,18408,907,206,42,18366,1165850,71634,0,0
3872,18592,0,226,0,18592,1184442,71408,0,0
3873,18800,1563,208,59,18741,1201679,71259,0,0
3874,18939,186967,198,2111,16828,1033651,73172,0,0
3875,17036,0,208,0,17036,1050687,72964,0,0
3876,17254,0,218,0,17254,1067941,72746,0,0
3877,17457,0,203,0,17457,1085398,72543,0,0
3878,17697,37477,240,639,17058,1065618,72942,0,0
3879,17277,0,219,0,17277,1082895,72723,0,0
3880,17485,0,208,0,17485,1100380,72515,0,0
3881,17704,0,219,0,17704,1118084,72296,0,0
3882,17928,0,224,0,17928,1136012,72072,0,0
3883,18146,0,218,0,18146,1154158,71854,0,0
3884,18379,0,233,0,18379,1172537,71621,0,0
3885,18582,0,203,0,18582,1191119,71418,0,0
3886,18795,54522,213,705,18090,1155392,71910,0,0
3887,18318,0,228,0,18318,1173710,71682,0,0
3888,18504,0,186,0,18504,1192214,71496,0,0
3889,18729,0,225,0,18729,1210943,71271,0,0
3890,18957,0,228,0,18957,1229900,71043,0,0
3891,19180,0,223,0,19180,1249080,70820,0,0
3892,19410,0,230,0,19410,1268490,70590,0,0
3893,19628,0,218,0,19628,1288118,70372,0,0
3894,19852,0,224,0,19852,1307970,70148,0,0
3895,20046,0,194,0,20046,1328016,69954,0,0
3896,20290,0,244,0,20290,1348306,69710,0,0
3897,20522,0,232,0,20522,1368828,69478,0,0
3898,20738,0,216,0,20738,1389566,69262,0,0
3899,20984,0,246,0,20984,1410550,69016,0,0
3900,21217,0,233,0,21217,1431767,68783,0,0
3901,21442,112383,225,1447,19995,1340826,70005,0,0
3902,20229,0,234,0,20229,1361055,69771,0,0
3903,20445,0,216,0,20445,1381500,69555,0,0
3904,20667,147634,222,2322,18345,1254533,71655,0,0
3905,18540,0,195,0,18540,1273073,71460,0,0
3906,18748,0,208,0,18748,1291821,71252,0,0
3907,18932,0,184,0,18932,1310753,71068,0,0
3908,19129,0,197,0,19129,1329882,70871,0,0
3909,19331,0,202,0,19331,1349213,70669,0,0
3910,19534,0,203,0,19534,1368747,70466,0,0
3911,19739,0,205,0,19739,1388486,70261,0,0
3912,19951,0,212,0,19951,1408437,70049,0,0
3913,20149,0,198,0,20149,1428586,69851,0,0
3914,20361,0,212,0,20361,1448947,69639,0,0
3915,20582,0,221,0,20582,1469529,69418,0,0
3916,20813,0,231,0,20813,1490342,69187,0,0
3917,21037,0,224,0,21037,1511379,68963,0,0
3918,21250,0,213,0,21250,1532629,68750,0,0
3919,21454,0,204,0,21454,1554083,68546,0,0
3920,21708,0,254,0,21708,1575791,68292,0,0
3921,21945,222914,237,2329,19616,1374822,70384,0,0
3922,19821,0,205,0,19821,1394643,70179,0,0
3923,20029,75586,208,1105,18924,1339086,71076,0,0
3924,19123,0,199,0,19123,1358209,70877,0,0
3925,19345,254583,222,2490,16855,1122971,73145,0,0
3926,17033,0,178,0,17033,1140004,72967,0,0
3927,17214,0,181,0,17214,1157218,72786,0,0
3928,17422,0,208,0,17422,1174640,72578,0,0
3929,17623,0,201,0,17623,1192263,72377,0,0
3930,17815,0,192,0,17815,1210078,72185,0,0
3931,18019,0,204,0,18019,1228097,71981,0,0
3932,18224,0,205,0,18224,1246321,71776,0,0
3933,18437,82591,213,893,17544,1182167,72456,0,0
3934,17755,0,211,0,17755,1199922,72245,0,0
3935,17955,0,200,0,17955,1217877,72045,0,0
3936,18145,0,190,0,18145,1236022,71855,0,0
3937,18372,0,227,0,18372,1254394,71628,0,0
3938,18558,103289,186,1620,16938,1169663,73062,0,0
3939,17114,0,176,0,17114,1186777,72886,0,0
3940,17315,0,201,0,17315,1204092,72685,0,0
3941,17510,187714,195,1917,15593,1033888,74407,0,0
3942,15793,0,200,0,15793,1049681,74207,0,0
3943,15984,0,191,0,15984,1065665,74016,0,0
3944,16173,0,189,0,16173,1081838,73827,0,0
3945,16355,0,182,0,16355,1098193,73645,0,0
3946,16556,0,201,0,16556,1114749,73444,0,0
3947,16748,0,192,0,16748,1131497,73252,0,0
3948,16935,92402,187,1043,15892,1056030,74108,0,0
3949,16095,0,203,0,16095,1072125,73905,0,0
3950,16292,0,197,0,16292,1088417,73708,0,0
3951,16491,290001,199,3450,13041,814907,76959,0,0
3952,13195,0,154,0,13195,828102,76805,0,0
3953,13356,0,161,0,13356,841458,76644,0,0
3954,13520,158404,164,2320,11200,696574,78800,0,0
3955,11356,0,156,0,11356,707930,78644,0,0
3956,11494,0,138,0,11494,719424,78506,0,0
3957,11659,0,165,0,11659,731083,78341,0,0
3958,11821,0,162,0,11821,742904,78179,0,0
3959,11975,0,154,0,11975,754879,78025,0,0
3960,12146,0,171,0,12146,767025,77854,0,0
3961,12321,0,175,0,12321,779346,77679,0,0
3962,12479,0,158,0,12479,791825,77521,0,0
3963,12648,0,169,0,12648,804473,77352,0,0
3964,12838,0,190,0,12838,817311,77162,0,0
3965,13008,0,170,0,13008,830319,76992,0,0
3966,13171,0,163,0,13171,843490,76829,0,0
3967,13367,0,196,0,13367,856857,76633,0,0
3968,13551,0,184,0,13551,870408,76449,0,0
3969,13748,0,197,0,13748,884156,76252,0,0
3970,13931,0,183,0,13931,898087,76069,0,0
3971,14133,0,202,0,14133,912220,75867,0,0
3972,14328,0,195,0,14328,926548,75672,0,0
3973,14516,0,188,0,14516,941064,75484,0,0
3974,14717,19265,201,326,14391,936516,75609,0,0
3975,14604,173348,213,1928,12676,777772,77324,0,0
3976,12848,0,172,0,12848,790620,77152,0,0
3977,13042,0,194,0,13042,803662,76958,0,0
3978,13223,0,181,0,13223,816885,76777,0,0
3979,13388,0,165,0,13388,830273,76612,0,0
3980,13612,0,224,0,13612,843885,76388,0,0
3981,13805,0,193,0,13805,857690,76195,0,0
3982,14009,41953,204,827,13182,829746,76818,0,0
3983,13347,0,165,0,13347,843093,76653,0,0
3984,13524,0,177,0,13524,856617,76476,0,0
3985,13711,159544,187,1957,11754,710784,78246,0,0
3986,11913,0,159,0,11913,722697,78087,0,0
3987,12122,0,209,0,12122,734819,77878,0,0
3988,12295,0,173,0,12295,747114,77705,0,0
3989,12473,0,178,0,12473,759587,77527,0,0
3990,12623,0,150,0,12623,772210,77377,0,0
3991,12807,0,184,0,12807,785017,77193,0,0
3992,13007,0,200,0,13007,798024,76993,0,0
3993,13198,0,191,0,13198,811222,76802,0,0
3994,13395,0,197,0,13395,824617,76605,0,0
3995,13585,0,190,0,13585,838202,76415,0,0
3996,13783,0,198,0,13783,851985,76217,0,0
3997,13967,0,184,0,13967,865952,76033,0,0
3998,14187,0,220,0,14187,880139,75813,0,0
3999,14399,0,212,0,14399,894538,75601,0,0
4000,14608,2464,209,81,14527,906682,75473,0,0
4001,14720,2692,193,88,14632,918710,75368,0,0
4002,14820,0,188,0,14820,933530,75180,0,0
4003,15018,0,198,0,15018,948548,74982,0,0
4004,15222,0,204,0,15222,963770,74778,0,0
4005,15431,0,209,0,15431,979201,74569,0,0
4006,15636,0,205,0,15636,994837,74364,0,0
4007,15883,0,247,0,15883,1010720,74117,0,0
4008,16103,0,220,0,16103,1026823,73897,0,0
4009,16348,30703,245,540,15808,1012468,74192,0,0
4010,16028,0,220,0,16028,1028496,73972,0,0
4011,16264,3254,236,95,16169,1041506,73831,0,0
4012,16363,13149,194,309,16054,1044720,73946,0,0
4013,16288,12959,234,372,15916,1048049,74084,0,0
4014,16133,0,217,0,16133,1064182,73867,0,0
4015,16338,0,205,0,16338,1080520,73662,0,0
4016,16550,0,212,0,16550,1097070,73450,0,0
4017,16748,0,198,0,16748,1113818,73252,0,0
4018,16966,0,218,0,16966,1130784,73034,0,0
4019,17180,0,214,0,17180,1147964,72820,0,0
4020,17403,1515,223,57,17346,1163852,72654,0,0
4021,17591,0,245,0,17591,1181443,72409,0,0
4022,17820,0,229,0,17820,1199263,72180,0,0
4023,18057,0,237,0,18057,1217320,71943,0,0
4024,18287,0,230,0,18287,1235607,71713,0,0
4025,18510,485470,223,4293,14217,768647,75783,0,0
4026,14417,0,200,0,14417,783064,75583,0,0
4027,14644,0,227,0,14644,797708,75356,0,0
4028,14861,0,217,0,14861,812569,75139,0,0
4029,15067,0,206,0,15067,827636,74933,0,0
4030,15288,0,221,0,15288,842924,74712,0,0
4031,15511,0,223,0,15511,858435,74489,0,0
4032,15729,0,218,0,15729,874164,74271,0,0
4033,15960,0,231,0,15960,890124,74040,0,0
4034,16190,0,230,0,16190,906314,73810,0,0
4035,16421,0,231,0,16421,922735,73579,0,0
4036,16623,0,202,0,16623,939358,73377,0,0
4037,16853,0,230,0,16853,956211,73147,0,0
4038,17090,102359,237,1281,15809,870942,74191,0,0
4039,16046,67986,237,996,15050,819002,74950,0,0
4040,15244,54826,194,819,14425,779420,75575,0,0
4041,14636,0,211,0,14636,794056,75364,0,0
4042,14878,0,242,0,14878,808934,75122,0,0
4043,15099,0,221,0,15099,824033,74901,0,0
4044,15288,0,189,0,15288,839321,74712,0,0
4045,15521,29175,233,473,15048,825667,74952,0,0
4046,15254,0,206,0,15254,840921,74746,0,0
4047,15471,0,217,0,15471,856392,74529,0,0
4048,15710,0,239,0,15710,872102,74290,0,0
4049,15938,0,228,0,15938,888040,74062,0,0
4050,16147,0,209,0,16147,904187,73853,0,0
4051,16366,0,219,0,16366,920553,73634,0,0
4052,16600,0,234,0,16600,937153,73400,0,0
4053,16825,0,225,0,16825,953978,73175,0,0
4054,17040,0,215,0,17040,971018,72960,0,0
4055,17299,0,259,0,17299,988317,72701,0,0
4056,17559,0,260,0,17559,1005876,72441,0,0
4057,17834,0,275,0,17834,1023710,72166,0,0
4058,18102,67890,268,1122,16980,973922,73020,0,0
4059,17186,76212,206,1240,15946,914896,74054,0,0
4060,16146,0,200,0,16146,931042,73854,0,0
4061,16386,0,240,0,16386,947428,73614,0,0
4062,16602,0,216,0,16602,964030,73398,0,0
4063,16840,0,238,0,16840,980870,73160,0,0
4064,17061,25542,221,431,16630,972389,73370,0,0
4065,16837,0,207,0,16837,989226,73163,0,0
4066,17082,0,245,0,17082,1006308,72918,0,0
4067,17317,0,235,0,17317,1023625,72683,0,0
4068,17551,0,234,0,17551,1041176,72449,0,0
4069,17786,0,235,0,17786,1058962,72214,0,0
4070,18010,0,224,0,18010,1076972,71990,0,0
4071,18250,0,240,0,18250,1095222,71750,0,0
4072,18506,102464,256,1549,16957,1011264,73043,0,0
4073,17177,0,220,0,17177,1028441,72823,0,0
4074,17407,0,230,0,17407,1045848,72593,0,0
4075,17633,0,226,0,17633,1063481,72367,0,0
4076,17904,0,271,0,17904,1081385,72096,0,0
4077,18129,29,225,2,18127,1099485,71873,0,0
4078,18333,0,206,0,18333,1117818,71667,0,0
4079,18563,0,230,0,18563,1136381,71437,0,0
4080,18817,0,254,0,18817,1155198,71183,0,0
4081,19065,0,248,0,19065,1174263,70935,0,0
4082,19302,0,237,0,19302,1193565,70698,0,0
4083,19551,0,249,0,19551,1213116,70449,0,0
4084,19778,0,227,0,19778,1232894,70222,0,0
4085,20027,250424,249,3229,16798,1002497,73202,0,0
4086,17015,0,217,0,17015,1019512,72985,0,0
4087,17226,0,211,0,17226,1036738,72774,0,0
4088,17452,0,226,0,17452,1054190,72548,0,0
4089,17695,0,243,0,17695,1071885,72305,0,0
4090,17936,9083,241,171,17765,1080738,72235,0,0
4091,18000,0,235,0,18000,1098738,72000,0,0
4092,18232,0,232,0,18232,1116970,71768,0,0
4093,18484,0,252,0,18484,1135454,71516,0,0
4094,18721,0,237,0,18721,1154175,71279,0,0
4095,18975,0,254,0,18975,1173150,71025,0,0
4096,19214,0,239,0,19214,1192364,70786,0,0
4097,19470,183652,256,1683,17787,1028182,72213,0,0
4098,17974,0,187,0,17974,1046156,72026,0,0
4099,18218,0,244,0,18218,1064374,71782,0,0
4100,18447,0,229,0,18447,1082821,71553,0,0
4101,18674,0,227,0,18674,1101495,71326,0,0
