Step,mass_grown,mass_burnt,trees_grown,trees_burnt,trees_count,trees_mass,ashes_count,ashes_mass,empty_count
100,14901,9413,68,107,14794,1210830,10008,0,65198
101,14859,6508,65,75,14784,1219181,10068,0,65148
102,14865,2577,81,30,14835,1231469,10092,0,65073
103,14910,12731,75,151,14759,1233648,10234,0,65007
104,14831,9996,72,106,14725,1238483,10322,0,64953
105,14792,8161,67,91,14701,1245114,10403,0,64896
106,14781,9546,80,105,14676,1250349,10493,0,64831
107,14757,10725,81,118,14639,1254381,10599,0,64762
108,14713,8758,74,97,14616,1260336,10687,0,64697
109,14684,6988,68,75,14609,1268032,10752,0,64639
110,14685,9983,76,110,14575,1272734,10855,0,64570
111,14641,3852,66,40,14601,1283523,10885,0,64514
112,14685,7569,84,77,14608,1290639,10945,0,64447
113,14673,6813,65,74,14599,1298499,11014,0,64387
114,14675,5742,76,63,14612,1307432,11068,0,64320
115,14694,8592,82,94,14600,1313534,11155,0,64245
116,14678,3214,78,33,14645,1324998,11172,0,64183
117,14733,7984,88,79,14654,1331747,11238,0,64108
118,14731,10994,77,112,14619,1335484,11337,0,64044
119,14685,12635,66,121,14564,1337534,11451,0,63985
120,14633,9214,69,93,14540,1342953,11535,0,63925
121,14604,9324,64,91,14513,1348233,11619,0,63868
122,14586,7827,73,82,14504,1354992,11688,0,63808
123,14584,13613,80,134,14450,1355963,11811,0,63739
124,14509,11197,59,106,14403,1359275,11909,0,63688
125,14466,3552,63,40,14426,1370189,11942,0,63632
126,14492,7187,66,72,14420,1377494,12000,0,63580
127,14496,12676,76,128,14368,1379314,12118,0,63514
128,14448,2615,80,24,14424,1391147,12131,0,63445
129,14484,18656,60,168,14316,1386975,12286,0,63398
130,14392,4290,76,41,14351,1397077,12318,0,63331
131,14452,10764,101,99,14353,1400765,12395,0,63252
132,14434,15775,81,146,14288,1399424,12527,0,63185
133,14370,14704,82,138,14232,1399090,12648,0,63120
134,14305,5845,73,56,14249,1407550,12693,0,63058
135,14328,6401,79,59,14269,1415477,12739,0,62992
136,14359,10185,90,96,14263,1419651,12818,0,62919
137,14335,10294,72,93,14242,1423692,12905,0,62853
138,14321,11703,79,106,14215,1426310,12999,0,62786
139,14298,10229,83,100,14198,1430379,13085,0,62717
140,14270,6273,72,57,14213,1438376,13132,0,62655
141,14293,14761,80,126,14167,1437908,13243,0,62590
142,14232,10938,65,97,14135,1441202,13332,0,62533
143,14223,7464,88,78,14145,1447961,13395,0,62460
144,14227,10538,82,98,14129,1451650,13477,0,62394
145,14199,16019,70,145,14054,1449830,13612,0,62334
146,14129,18837,75,164,13965,1445122,13764,0,62271
147,14049,13558,84,124,13925,1445613,13880,0,62195
148,13998,14280,73,132,13866,1445331,13999,0,62135
149,13927,23044,61,202,13725,1436214,14189,0,62086
150,13805,11051,80,105,13700,1438968,14280,0,62020
151,13770,9631,70,81,13689,1443107,14344,0,61967
152,13767,10085,78,82,13685,1446789,14405,0,61910
153,13766,3500,81,36,13730,1457055,14419,0,61851
154,13810,11471,80,92,13718,1459394,14501,0,61781
155,13794,8268,76,69,13725,1464920,14553,0,61722
156,13806,5366,81,45,13761,1473360,14583,0,61656
157,13835,15302,74,127,13708,1471893,14693,0,61599
158,13772,21729,64,165,13607,1463936,14846,0,61547
159,13681,6381,74,53,13628,1471236,14885,0,61487
160,13704,8943,76,69,13635,1475997,14943,0,61422
161,13732,7514,97,70,13662,1482215,14996,0,61342
162,13748,8320,86,71,13677,1487643,15045,0,61278
163,13746,16624,69,128,13618,1484765,15157,0,61225
164,13700,11011,82,86,13614,1487454,15218,0,61168
165,13692,5482,78,44,13648,1495664,15245,0,61107
166,13725,3931,77,30,13695,1505458,15263,0,61042
167,13783,14786,88,118,13665,1504455,15369,0,60966
168,13735,15575,70,127,13608,1502615,15483,0,60909
169,13698,11589,90,95,13603,1504724,15561,0,60836
170,13676,6214,73,51,13625,1512186,15597,0,60778
171,13709,16781,84,136,13573,1509114,15710,0,60717
172,13642,13961,69,100,13542,1508795,15792,0,60666
173,13611,13738,69,112,13499,1508668,15885,0,60616
174,13586,10213,87,75,13511,1512041,15942,0,60547
175,13572,5805,61,45,13527,1519808,15972,0,60501
176,13608,17477,81,143,13465,1515939,16093,0,60442
177,13534,9393,69,74,13460,1520080,16155,0,60385
178,13523,16833,63,133,13390,1516770,16274,0,60336
179,13454,9834,64,70,13384,1520390,16325,0,60291
180,13465,12687,81,95,13370,1521168,16408,0,60222
181,13443,8796,73,75,13368,1525815,16467,0,60165
182,13440,13549,72,103,13337,1525706,16560,0,60103
183,13428,14367,91,100,13328,1524767,16644,0,60028
184,13395,8726,67,78,13317,1529436,16707,0,59976
185,13402,14221,85,110,13292,1528617,16791,0,59917
186,13376,14529,84,115,13261,1527464,16888,0,59851
187,13337,13312,76,102,13235,1527489,16978,0,59787
188,13305,15773,70,115,13190,1525021,17082,0,59728
189,13287,8892,97,77,13210,1529416,17139,0,59651
190,13293,11168,83,88,13205,1531541,17204,0,59591
191,13287,14612,82,114,13173,1530216,17298,0,59529
192,13264,13471,91,99,13165,1530009,17381,0,59454
193,13243,14447,78,109,13134,1528805,17471,0,59395
194,13227,10497,93,82,13145,1531535,17524,0,59331
195,13237,15940,92,116,13121,1528832,17613,0,59266
196,13207,11162,86,84,13123,1530877,17668,0,59209
197,13197,14319,74,103,13094,1529755,17753,0,59153
198,13173,5520,79,48,13125,1537408,17780,0,59095
199,13196,14319,71,107,13089,1536285,17874,0,59037
200,13168,7316,79,52,13116,1542137,17911,0,58973
201,13193,16753,77,117,13076,1538577,18005,0,58919
202,13154,13053,78,96,13058,1538678,18074,0,58868
203,13141,12424,83,86,13055,1539395,18141,0,58804
204,13129,8812,74,66,13063,1543712,18193,0,58744
205,13131,10193,68,73,13058,1546650,18252,0,58690
206,13137,16558,79,121,13016,1543229,18350,0,58634
207,13105,8524,89,64,13041,1547810,18397,0,58562
208,13111,10563,70,76,13035,1550358,18458,0,58507
209,13116,8238,81,59,13057,1555236,18497,0,58446
210,13141,8479,84,67,13074,1559898,18546,0,58380
211,13140,10818,66,71,13069,1562220,18596,0,58335
212,13128,17039,59,119,13009,1558309,18699,0,58292
213,13085,20472,76,137,12948,1550922,18818,0,58234
214,13031,11928,83,82,12949,1552025,18876,0,58175
215,13034,9373,85,77,12957,1555686,18932,0,58111
216,13033,4030,76,33,13000,1564689,18949,0,58051
217,13070,10673,70,81,12989,1567086,19013,0,57998
218,13056,7498,67,50,13006,1572644,19050,0,57944
219,13067,12452,61,85,12982,1573259,19123,0,57895
220,13055,14218,73,94,12961,1572096,19198,0,57841
221,13042,7752,81,55,12987,1577386,19234,0,57779
222,13067,10081,80,70,12997,1580372,19289,0,57714
223,13066,5695,69,60,13006,1587743,19337,0,57657
224,13082,5553,76,42,13040,1595272,19361,0,57599
225,13114,19520,74,127,12987,1588866,19467,0,57546
226,13062,10967,75,76,12986,1590961,19524,0,57490
227,13079,6105,93,52,13027,1597935,19559,0,57414
228,13100,10185,73,70,13030,1600850,19608,0,57362
229,13099,13792,69,96,13003,1600157,19690,0,57307
230,13084,12707,81,90,12994,1600534,19760,0,57246
231,13070,6861,76,52,13018,1606743,19795,0,57187
232,13095,15551,77,102,12993,1604287,19879,0,57128
233,13074,10279,81,73,13001,1607082,19930,0,57069
234,13084,12113,83,80,13004,1608053,19994,0,57002
235,13070,8374,66,54,13016,1612749,20028,0,56956
236,13079,4205,63,28,13051,1621623,20039,0,56910
237,13112,5353,61,40,13072,1629382,20064,0,56864
238,13148,10323,76,73,13075,1632207,20123,0,56802
239,13179,10744,104,74,13105,1634642,20183,0,56712
240,13187,18477,82,129,13058,1629352,20292,0,56650
241,13137,8670,79,58,13079,1633819,20332,0,56589
242,13162,10715,83,67,13095,1636266,20373,0,56532
243,13167,8719,72,67,13100,1640714,20425,0,56475
244,13182,12337,82,84,13098,1641559,20484,0,56418
245,13179,15621,81,103,13076,1639117,20565,0,56359
246,13153,11760,77,90,13063,1640510,20633,0,56304
247,13146,7231,83,53,13093,1646425,20655,0,56252
248,13168,16163,75,111,13057,1643430,20745,0,56198
249,13126,7830,69,58,13068,1648726,20784,0,56148
250,13132,12013,64,78,13054,1649845,20843,0,56103
251,13137,15151,83,118,13019,1647831,20937,0,56044
252,13095,12533,76,87,13008,1648393,21004,0,55988
253,13087,22192,79,143,12944,1639288,21130,0,55926
254,13028,11186,84,73,12955,1641130,21177,0,55868
255,13042,18577,87,116,12926,1635595,21269,0,55805
256,12995,11889,69,83,12912,1636701,21335,0,55753
257,12997,9402,85,75,12922,1640296,21393,0,55685
258,13002,10592,80,74,12928,1642706,21446,0,55626
259,13018,10548,90,74,12944,1645176,21500,0,55556
260,13026,15266,82,100,12926,1642936,21579,0,55495
261,13006,5739,80,44,12962,1650203,21608,0,55430
262,13051,4934,89,31,13020,1658320,21613,0,55367
263,13101,7847,81,57,13044,1663574,21653,0,55303
264,13114,11447,70,82,13032,1665241,21723,0,55245
265,13113,18168,81,128,12985,1660186,21820,0,55195
266,13076,7602,91,56,13020,1665660,21844,0,55136
267,13101,16832,81,111,12990,1661929,21936,0,55074
268,13073,19089,83,125,12948,1655913,22038,0,55014
269,13014,7936,66,57,12957,1660991,22074,0,54969
270,13055,12203,98,95,12960,1661843,22136,0,54904
271,13024,11042,64,72,12952,1663825,22195,0,54853
272,13023,10517,71,79,12944,1666331,22254,0,54802
273,13033,11335,89,73,12960,1668029,22297,0,54743
274,13051,15192,91,94,12957,1665888,22360,0,54683
275,13027,11785,70,89,12938,1667130,22425,0,54637
276,13008,12153,70,81,12927,1667985,22484,0,54589
277,13009,7275,82,57,12952,1673719,22512,0,54536
278,13053,10830,101,75,12978,1675942,22558,0,54464
279,13046,11305,68,79,12967,1677683,22616,0,54417
280,13042,14214,75,82,12960,1676511,22681,0,54359
281,13031,13675,71,86,12945,1675867,22745,0,54310
282,13024,17910,79,114,12910,1670981,22840,0,54250
283,12993,7055,83,44,12949,1676919,22857,0,54194
284,13022,6806,73,46,12976,1683135,22878,0,54146
285,13046,13092,70,76,12970,1683089,22924,0,54106
286,13071,4541,101,36,13035,1691619,22926,0,54039
287,13111,6985,76,54,13057,1697745,22964,0,53979
288,13134,8757,77,57,13077,1702122,23000,0,53923
289,13157,3259,80,35,13122,1712020,23009,0,53869
290,13191,10085,69,72,13119,1715126,23059,0,53822
291,13208,10219,89,71,13137,1718115,23101,0,53762
292,13219,8375,82,54,13165,1722959,23131,0,53704
293,13233,12144,68,84,13149,1724048,23192,0,53659
294,13231,5000,82,44,13187,1732279,23206,0,53607
295,13262,5733,75,38,13224,1739808,23221,0,53555
296,13307,19537,83,119,13188,1733578,23306,0,53506
297,13259,10339,71,67,13192,1736498,23347,0,53461
298,13260,15410,68,92,13168,1734348,23421,0,53411
299,13256,6317,88,38,13218,1741287,23432,0,53350
300,13295,17327,77,105,13190,1737255,23508,0,53302
301,13270,19260,80,123,13147,1731265,23611,0,53242
302,13223,9108,76,62,13161,1735380,23646,0,53193
303,13224,15999,63,107,13117,1732605,23737,0,53146
304,13207,8345,90,59,13148,1737467,23764,0,53088
305,13217,3754,69,34,13183,1746930,23775,0,53042
306,13259,12028,76,71,13188,1748161,23826,0,52986
307,13262,15351,74,101,13161,1746072,23899,0,52940
308,13248,12618,87,99,13149,1746702,23979,0,52872
309,13223,6829,74,55,13168,1753096,24011,0,52821
310,13258,11004,90,71,13187,1755350,24059,0,52754
311,13258,3432,71,27,13231,1765176,24053,0,52716
312,13311,12076,80,75,13236,1766411,24108,0,52656
313,13318,6839,82,53,13265,1772890,24133,0,52602
314,13342,9690,77,55,13287,1776542,24165,0,52548
315,13377,11028,90,80,13297,1778891,24217,0,52486
316,13380,5601,83,48,13332,1786670,24244,0,52424
317,13394,13071,62,87,13307,1786993,24315,0,52378
318,13378,10391,71,68,13310,1789980,24362,0,52328
319,13392,7626,82,50,13342,1795746,24386,0,52272
320,13418,2820,76,16,13402,1806344,24375,0,52223
321,13480,10285,78,67,13413,1809539,24421,0,52166
322,13476,10716,63,66,13410,1812299,24466,0,52124
323,13497,4276,87,32,13465,1821520,24472,0,52063
324,13556,8183,91,59,13497,1826893,24512,0,51991
325,13571,14113,74,97,13474,1826351,24587,0,51939
326,13552,10218,78,66,13486,1829685,24627,0,51887
327,13560,16974,74,113,13447,1826271,24720,0,51833
328,13514,18849,67,109,13405,1820936,24803,0,51792
329,13479,9732,74,57,13422,1824683,24834,0,51744
330,13486,18008,64,109,13377,1820161,24919,0,51704
331,13441,19635,64,105,13336,1813967,25001,0,51663
332,13412,25745,76,138,13274,1801634,25112,0,51614
333,13347,11915,73,62,13285,1803066,25154,0,51561
334,13373,11272,88,82,13291,1805167,25209,0,51500
335,13369,11257,78,67,13302,1807279,25254,0,51444
336,13372,6135,70,39,13333,1814516,25266,0,51401
337,13416,12020,83,73,13343,1815912,25313,0,51344
338,13427,11388,84,84,13343,1817951,25370,0,51287
339,13417,17551,74,109,13308,1813817,25460,0,51232
340,13390,14757,82,98,13292,1812450,25536,0,51172
341,13369,9447,77,54,13315,1816372,25565,0,51120
342,13390,8483,75,54,13336,1821279,25599,0,51065
343,13413,18851,77,110,13303,1815841,25679,0,51018
344,13391,11706,88,66,13325,1817526,25721,0,50954
345,13413,8195,88,48,13365,1822744,25740,0,50895
346,13426,11182,61,74,13352,1824988,25796,0,50852
347,13427,6218,75,48,13379,1832197,25814,0,50807
348,13449,12122,70,82,13367,1833524,25870,0,50763
349,13438,6387,71,49,13389,1840575,25899,0,50712
350,13479,22286,90,128,13351,1831768,26004,0,50645
351,13421,722,70,9,13412,1844467,25990,0,50598
352,13469,8817,57,52,13417,1849119,26016,0,50567
353,13505,14062,88,86,13419,1848562,26067,0,50514
354,13491,4926,72,35,13456,1857127,26070,0,50474
355,13527,20652,71,120,13407,1850002,26165,0,50428
356,13496,12941,89,96,13400,1850557,26236,0,50364
357,13485,12936,85,88,13397,1851106,26302,0,50301
358,13485,8174,88,55,13430,1856417,26330,0,50240
359,13487,5493,57,46,13441,1864411,26352,0,50207
360,13516,6618,75,56,13460,1871309,26377,0,50163
361,13553,2579,93,20,13533,1882283,26365,0,50102
362,13625,14401,92,103,13522,1881507,26443,0,50035
363,13597,12970,75,72,13525,1882134,26489,0,49986
364,13593,7399,68,47,13546,1888328,26514,0,49940
365,13611,16814,65,108,13503,1885125,26597,0,49900
366,13572,11622,69,69,13503,1887075,26635,0,49862
367,13587,22690,84,138,13449,1877972,26751,0,49800
368,13518,2656,69,22,13496,1888834,26758,0,49746
369,13578,12575,82,79,13499,1889837,26809,0,49692
370,13572,11629,73,59,13513,1891780,26846,0,49641
371,13594,9318,81,55,13539,1896056,26868,0,49593
372,13625,20423,86,112,13513,1889258,26946,0,49541
373,13591,10549,78,68,13523,1892300,26988,0,49489
374,13584,3180,61,19,13565,1902704,26985,0,49450
375,13644,12660,79,77,13567,1903688,27036,0,49397
376,13654,9459,87,66,13588,1907883,27067,0,49345
377,13676,9287,88,60,13616,1912272,27100,0,49284
378,13689,3361,73,30,13659,1922600,27104,0,49237
379,13744,12309,85,82,13662,1924035,27163,0,49175
380,13740,9001,78,49,13691,1928774,27184,0,49125
381,13776,16655,85,105,13671,1925895,27261,0,49068
382,13747,6448,76,54,13693,1933194,27287,0,49020
383,13783,20471,90,127,13656,1926506,27376,0,48968
384,13732,15525,76,88,13644,1924713,27433,0,48923
385,13712,4371,68,30,13682,1934054,27435,0,48883
386,13742,1085,60,11,13731,1946711,27424,0,48845
387,13796,11126,65,62,13734,1949381,27458,0,48808
388,13811,3011,77,23,13788,1960181,27456,0,48756
389,13859,9826,71,63,13796,1964214,27489,0,48715
390,13864,7459,68,50,13814,1970619,27515,0,48671
391,13894,19718,80,88,13806,1964795,27576,0,48618
392,13892,8505,86,58,13834,1970182,27600,0,48566
393,13900,24614,66,147,13753,1959468,27726,0,48521
394,13842,18841,89,104,13738,1954469,27797,0,48465
395,13800,9778,62,62,13738,1958491,27835,0,48427
396,13831,22195,93,111,13720,1950127,27911,0,48369
397,13800,11751,80,60,13740,1952176,27950,0,48310
398,13815,15865,75,100,13715,1950126,28019,0,48266
399,13778,11486,63,54,13724,1952418,28047,0,48229
400,13815,28648,91,140,13675,1937585,28156,0,48169
401,13754,18762,79,100,13654,1932577,28225,0,48121
402,13734,9143,80,64,13670,1937168,28260,0,48070
403,13745,8116,75,47,13698,1942797,28273,0,48029
404,13758,7372,60,55,13703,1949183,28302,0,47995
405,13783,12291,80,70,13713,1950675,28334,0,47953
406,13787,16433,74,105,13682,1948029,28410,0,47908
407,13757,18389,75,92,13665,1943397,28479,0,47856
408,13749,15934,84,84,13665,1941212,28536,0,47799
409,13735,10687,70,65,13670,1944260,28584,0,47746
410,13740,12449,70,64,13676,1945551,28622,0,47702
411,13747,21553,71,121,13626,1937745,28717,0,47657
412,13701,5514,75,40,13661,1945932,28723,0,47616
413,13731,14568,70,87,13644,1945095,28784,0,47572
414,13722,25308,78,135,13587,1933509,28888,0,47525
415,13649,7062,62,48,13601,1940096,28912,0,47487
416,13686,11997,85,64,13622,1941785,28945,0,47433
417,13699,8111,77,54,13645,1947373,28978,0,47377
418,13734,9747,89,68,13666,1951360,29013,0,47321
419,13740,21435,74,116,13624,1943665,29099,0,47277
420,13699,23703,75,146,13553,1933661,29216,0,47231
421,13625,12301,72,66,13559,1934985,29255,0,47186
422,13632,12170,73,90,13542,1936447,29313,0,47145
423,13618,8065,76,35,13583,1942000,29324,0,47093
424,13666,6565,83,41,13625,1949101,29335,0,47040
425,13694,12917,69,85,13609,1949878,29393,0,46998
426,13676,17487,67,93,13583,1946067,29467,0,46950
427,13658,4120,75,45,13613,1955605,29489,0,46898
428,13690,17532,77,96,13594,1951763,29558,0,46848
429,13673,14316,79,85,13588,1951120,29615,0,46797
430,13664,4414,76,35,13629,1960370,29615,0,46756
431,13716,21908,87,127,13589,1952178,29711,0,46700
432,13671,10232,82,60,13611,1955617,29747,0,46642
433,13682,14543,71,79,13603,1954756,29803,0,46594
434,13691,15161,88,84,13607,1953286,29852,0,46541
435,13697,6904,90,54,13643,1960079,29868,0,46489
436,13714,16977,71,102,13612,1956816,29946,0,46442
437,13671,6611,59,47,13624,1963876,29974,0,46402
438,13685,1996,61,14,13671,1975565,29966,0,46363
439,13743,14167,72,91,13652,1975141,30032,0,46316
440,13732,3899,80,30,13702,1984974,30032,0,46266
441,13758,9804,56,56,13702,1988928,30071,0,46227
442,13781,11210,79,63,13718,1991499,30099,0,46183
443,13799,10908,81,60,13739,1994390,30124,0,46137
444,13810,7365,71,45,13765,2000835,30134,0,46101
445,13835,7068,70,41,13794,2007602,30151,0,46055
446,13861,15784,67,89,13772,2005679,30207,0,46021
447,13852,25677,80,123,13729,1993854,30295,0,45976
448,13810,8514,81,51,13759,1999150,30313,0,45928
449,13850,8638,91,44,13806,2004362,30320,0,45874
450,13885,11696,79,73,13812,2006551,30357,0,45831
451,13889,5436,77,36,13853,2015004,30370,0,45777
452,13933,14661,80,95,13838,2014276,30438,0,45724
453,13908,4178,70,48,13860,2024006,30461,0,45679
454,13932,26134,72,144,13788,2011804,30575,0,45637
455,13860,18814,72,118,13742,2006850,30657,0,45601
456,13812,3943,70,38,13774,2016719,30663,0,45563
457,13850,10092,76,58,13792,2020477,30693,0,45515
458,13879,21928,87,123,13756,2012428,30778,0,45466
459,13827,8849,71,59,13768,2017406,30810,0,45422
460,13849,20067,81,111,13738,2011188,30889,0,45373
461,13806,15685,68,99,13707,2009309,30963,0,45330
462,13798,10566,91,73,13725,2012541,30998,0,45277
463,13803,16142,78,99,13704,2010202,31061,0,45235
464,13779,11057,75,66,13713,2012924,31097,0,45190
465,13788,18209,75,119,13669,2008503,31188,0,45143
466,13758,4885,89,40,13718,2017376,31188,0,45094
467,13801,11538,83,58,13743,2019639,31207,0,45050
468,13824,12914,81,78,13746,2020549,31246,0,45008
469,13809,16811,63,103,13706,2017547,31326,0,44968
470,13800,19279,94,108,13692,2012068,31388,0,44920
471,13780,15236,88,97,13683,2010612,31450,0,44867
472,13765,9846,82,76,13689,2014531,31491,0,44820
473,13778,20453,89,101,13677,2007856,31552,0,44771
474,13751,7334,74,46,13705,2014273,31566,0,44729
475,13787,10355,82,61,13726,2017705,31593,0,44681
476,13802,9174,76,67,13735,2022333,31636,0,44629
477,13808,21625,73,140,13668,2014516,31747,0,44585
478,13742,10450,74,54,13688,2017808,31772,0,44540
479,13759,13139,71,78,13681,2018428,31822,0,44497
480,13760,17590,79,111,13649,2014598,31904,0,44447
481,13723,6148,74,46,13677,2022173,31913,0,44410
482,13758,12197,81,78,13680,2023734,31956,0,44364
483,13744,21330,64,119,13625,2016148,32046,0,44329
484,13697,14160,72,80,13617,2015685,32093,0,44290
485,13687,16733,70,97,13590,2012639,32164,0,44246
486,13682,13530,92,61,13621,2012791,32170,0,44209
487,13694,7262,73,57,13637,2019223,32190,0,44173
488,13730,20142,93,128,13602,2012811,32287,0,44111
489,13688,7474,86,46,13642,2019025,32296,0,44062
490,13720,8689,78,54,13666,2024056,32317,0,44017
491,13734,8702,68,54,13680,2029088,32347,0,43973
492,13745,15494,65,88,13657,2027339,32411,0,43932
493,13727,16805,70,103,13624,2024261,32475,0,43901
494,13692,26221,68,152,13540,2011732,32597,0,43863
495,13616,19840,76,105,13511,2005508,32668,0,43821
496,13591,12866,80,80,13511,2006233,32711,0,43778
497,13583,11645,72,74,13509,2008171,32760,0,43731
498,13597,13056,88,91,13506,2008712,32813,0,43681
499,13586,19606,80,111,13475,2002692,32884,0,43641
500,13539,14124,64,85,13454,2002107,32934,0,43612
501,13512,16907,58,81,13431,1998712,32991,0,43578
502,13505,12792,74,69,13436,1999425,33027,0,43537
503,13506,12642,70,75,13431,2000289,33071,0,43498
504,13499,4048,68,30,13469,2009740,33065,0,43466
505,13542,9974,73,62,13480,2013308,33098,0,43422
506,13572,13795,92,87,13485,2013085,33149,0,43366
507,13579,11678,94,71,13508,2014986,33185,0,43307
508,13592,22580,84,129,13463,2005998,33281,0,43256
509,13549,11438,86,58,13491,2008109,33301,0,43208
510,13561,12047,70,79,13482,2009623,33346,0,43172
511,13564,4177,82,34,13530,2019010,33338,0,43132
512,13610,16070,80,94,13516,2016550,33397,0,43087
513,13597,10221,81,62,13535,2019926,33423,0,43042
514,13614,15929,79,83,13531,2017611,33470,0,42999
515,13616,28162,85,144,13472,2003065,33576,0,42952
516,13548,15720,76,74,13474,2000893,33615,0,42911
517,13550,3002,76,21,13529,2011441,33606,0,42865
518,13606,6162,77,43,13563,2018885,33622,0,42815
519,13646,9222,83,58,13588,2023309,33640,0,42772
520,13673,10855,85,66,13607,2026127,33665,0,42728
521,13676,13338,69,68,13608,2026465,33702,0,42690
522,13702,10866,94,61,13641,2029301,33716,0,42643
523,13718,10900,77,58,13660,2032119,33740,0,42600
524,13735,11645,75,69,13666,2034209,33780,0,42554
525,13744,12178,78,68,13676,2035775,33811,0,42513
526,13750,8646,74,50,13700,2040879,33828,0,42472
527,13770,7617,70,62,13708,2047032,33860,0,42432
528,13772,20041,64,117,13655,2040763,33951,0,42394
529,13736,5715,81,37,13699,2048784,33959,0,42342
530,13778,13035,79,81,13697,2049527,34006,0,42297
531,13767,16262,70,81,13686,2047032,34058,0,42256
532,13774,10110,88,56,13718,2050696,34077,0,42205
533,13779,23505,61,135,13644,2040970,34185,0,42171
534,13732,13282,88,91,13641,2041420,34239,0,42120
535,13729,6706,88,39,13690,2048443,34232,0,42078
536,13760,26272,70,152,13608,2035931,34353,0,42039
537,13694,12198,86,78,13616,2037427,34401,0,41983
538,13686,24771,70,130,13556,2026342,34501,0,41943
539,13609,10022,53,47,13562,2029929,34524,0,41914
540,13630,15587,68,79,13551,2027972,34566,0,41883
541,13643,14580,92,79,13564,2027035,34607,0,41829
542,13632,16939,68,89,13543,2023728,34663,0,41794
543,13636,5204,93,33,13603,2032160,34654,0,41743
544,13682,7567,79,45,13637,2038275,34666,0,41697
545,13713,9947,76,59,13654,2042041,34691,0,41655
546,13732,11613,78,74,13658,2044160,34725,0,41617
547,13733,9874,75,54,13679,2048019,34748,0,41573
548,13757,7190,78,44,13713,2054586,34754,0,41533
549,13789,9919,76,78,13711,2058456,34789,0,41500
550,13798,16411,87,75,13723,2055843,34826,0,41451
551,13804,9680,81,59,13745,2059967,34854,0,41401
552,13824,11597,79,71,13753,2062194,34889,0,41358
553,13816,15641,63,84,13732,2060369,34941,0,41327
554,13792,12902,60,74,13718,2061259,34989,0,41293
555,13802,12864,84,86,13716,2062197,35037,0,41247
556,13768,4878,52,41,13727,2071087,35052,0,41221
557,13811,15529,84,82,13729,2069369,35094,0,41177
558,13798,13991,69,86,13712,2069176,35147,0,41141
559,13802,8703,90,56,13746,2074275,35158,0,41096
560,13829,13473,83,71,13758,2074631,35191,0,41051
561,13833,6200,75,45,13788,2082264,35201,0,41011
562,13875,6487,87,40,13835,2089652,35203,0,40962
563,13908,14125,73,90,13818,2089435,35258,0,40924
564,13884,11515,66,66,13818,2091804,35293,0,40889
565,13892,4072,74,26,13866,2101624,35293,0,40841
566,13948,6821,82,42,13906,2108751,35297,0,40797
567,13976,15581,70,87,13889,2107146,35344,0,40767
568,13969,21097,80,120,13849,2100018,35432,0,40719
569,13908,25699,59,140,13768,2088227,35546,0,40686
570,13848,13989,80,75,13773,2088086,35584,0,40643
571,13842,19432,69,115,13727,2082496,35663,0,40610
572,13805,22152,78,121,13684,2074149,35753,0,40563
573,13753,18264,69,102,13651,2069638,35832,0,40517
574,13719,32695,68,164,13555,2050662,35966,0,40479
575,13627,4010,72,27,13600,2060279,35954,0,40446
576,13678,16104,78,76,13602,2057853,35995,0,40403
577,13676,8351,74,50,13626,2063178,36003,0,40371
578,13700,3740,74,26,13674,2073138,35987,0,40339
579,13748,11605,74,67,13681,2075281,36020,0,40299
580,13765,15147,84,85,13680,2073899,36066,0,40254
581,13757,17564,77,93,13664,2070092,36118,0,40218
582,13727,19157,63,91,13636,2064662,36175,0,40189
583,13711,22516,75,109,13602,2055857,36246,0,40152
584,13679,15077,77,89,13590,2054459,36301,0,40109
585,13672,6928,82,52,13620,2061203,36310,0,40070
586,13697,35002,77,185,13512,2039898,36455,0,40033
587,13595,14185,83,80,13515,2039308,36485,0,40000
588,13582,11562,67,69,13513,2041328,36519,0,39968
589,13581,6037,68,39,13542,2048872,36526,0,39932
590,13611,11026,69,59,13552,2051457,36557,0,39891
591,13633,631,81,7,13626,2064459,36533,0,39841
592,13703,5466,77,50,13653,2072696,36547,0,39800
593,13723,6634,70,39,13684,2079785,36545,0,39771
594,13753,8655,69,58,13695,2084883,36567,0,39738
595,13756,7492,61,49,13707,2091147,36593,0,39700
596,13782,18622,75,85,13697,2086307,36646,0,39657
597,13773,17317,76,87,13686,2082763,36694,0,39620
598,13762,18348,76,120,13642,2078177,36779,0,39579
599,13740,6461,98,46,13694,2085456,36784,0,39522
600,13781,17845,87,99,13682,2081392,36837,0,39481
601,13765,16476,83,82,13683,2078681,36881,0,39436
602,13748,17814,65,107,13641,2074615,36953,0,39406
603,13703,17630,62,109,13594,2070688,37032,0,39374
604,13656,21711,62,127,13529,2062633,37133,0,39338
605,13606,7849,77,48,13558,2068390,37139,0,39303
606,13637,15103,79,73,13564,2066924,37173,0,39263
607,13650,22540,86,108,13542,2058034,37235,0,39223
608,13619,14038,77,95,13524,2057615,37294,0,39182
609,13607,8127,83,48,13559,2063095,37297,0,39144
610,13619,18677,60,98,13521,2058037,37363,0,39116
611,13593,6428,72,50,13543,2065202,37377,0,39080
612,13634,15175,91,92,13542,2063661,37427,0,39031
613,13612,10116,70,64,13548,2067157,37453,0,38999
614,13630,9267,82,62,13568,2071520,37469,0,38963
615,13629,11978,61,64,13565,2073171,37500,0,38935
616,13635,14772,70,87,13548,2072034,37557,0,38895
617,13617,20912,69,91,13526,2064739,37613,0,38861
618,13596,16740,70,81,13515,2061595,37662,0,38823
619,13590,17477,75,102,13488,2057708,37733,0,38779
620,13572,7740,84,56,13516,2063540,37749,0,38735
621,13599,20774,83,118,13481,2056365,37822,0,38697
622,13566,27373,85,135,13431,2042558,37917,0,38652
623,13507,12417,76,66,13441,2043648,37941,0,38618
624,13514,9165,73,54,13460,2047997,37961,0,38579
625,13528,10430,68,70,13458,2051095,37995,0,38547
626,13541,8962,83,53,13488,2055674,38013,0,38499
627,13573,6638,85,37,13536,2062609,38014,0,38450
628,13601,18355,65,99,13502,2057855,38082,0,38416
629,13573,13177,71,68,13505,2058251,38108,0,38387
630,13581,7030,76,46,13535,2064802,38115,0,38350
631,13605,5005,70,36,13569,2073402,38115,0,38316
632,13644,5300,75,43,13601,2081746,38119,0,38280
633,13675,5076,74,30,13645,2090345,38109,0,38246
634,13709,4626,64,31,13678,2099428,38104,0,38218
635,13749,22602,71,103,13646,2090575,38169,0,38185
636,13717,9683,71,62,13655,2094609,38207,0,38138
637,13735,6635,80,44,13691,2101709,38210,0,38099
638,13775,19016,84,109,13666,2096468,38282,0,38052
639,13747,10056,81,50,13697,2100159,38287,0,38016
640,13769,13272,72,80,13689,2100656,38336,0,37975
641,13760,18603,71,107,13653,2095813,38414,0,37933
642,13725,20970,72,129,13596,2088568,38501,0,37903
643,13686,8174,90,39,13647,2094080,38493,0,37860
644,13723,9474,76,61,13662,2098329,38515,0,37823
645,13728,8418,66,59,13669,2103639,38541,0,37790
646,13746,18782,77,101,13645,2098603,38606,0,37749
647,13746,33024,101,172,13574,2079325,38722,0,37704
648,13647,10210,73,56,13591,2082762,38741,0,37668
649,13671,7059,80,34,13637,2089374,38738,0,37625
650,13715,11409,78,70,13645,2091680,38759,0,37596
651,13717,16895,72,97,13620,2088502,38818,0,37562
652,13707,19725,87,117,13590,2082484,38889,0,37521
653,13678,10991,88,72,13606,2085171,38918,0,37476
654,13699,10822,93,66,13633,2088048,38933,0,37434
655,13722,12044,89,70,13652,2089726,38951,0,37397
656,13719,23956,67,130,13589,2079489,39054,0,37357
657,13660,15362,71,80,13580,2077787,39094,0,37326
658,13647,9858,67,67,13580,2081576,39124,0,37296
659,13678,16479,98,99,13579,2078775,39166,0,37255
660,13644,19183,65,102,13542,2073236,39241,0,37217
661,13628,12375,86,77,13551,2074489,39278,0,37171
662,13635,15243,84,94,13541,2072881,39330,0,37129
663,13614,10415,73,60,13554,2076080,39353,0,37093
664,13653,10706,99,71,13582,2079027,39361,0,37057
665,13660,21836,78,119,13541,2070851,39434,0,37025
666,13619,21921,78,115,13504,2062549,39508,0,36988
667,13588,10727,84,62,13526,2065410,39522,0,36952
668,13602,8463,76,44,13558,2070549,39526,0,36916
669,13625,11608,67,72,13553,2072566,39568,0,36879
670,13625,5131,72,34,13591,2081060,39562,0,36847
671,13664,14223,73,78,13586,2080501,39596,0,36818
672,13671,8871,85,57,13614,2085301,39609,0,36777
673,13703,14526,89,66,13637,2084478,39619,0,36744
674,13717,17509,80,102,13615,2080686,39678,0,36707
675,13687,27651,72,157,13530,2066722,39797,0,36673
676,13619,6449,89,38,13581,2073892,39780,0,36639
677,13665,12363,84,74,13591,2075194,39817,0,36592
678,13667,12154,76,78,13589,2076707,39852,0,36559
679,13663,32708,74,167,13496,2057662,39979,0,36525
680,13568,15852,72,103,13465,2055378,40041,0,36494
681,13557,4848,92,27,13530,2064087,40019,0,36451
682,13620,4534,90,32,13588,2073173,40010,0,36402
683,13664,21668,76,109,13555,2065169,40086,0,36359
684,13644,13113,89,81,13563,2065700,40118,0,36319
685,13648,21835,85,119,13529,2057513,40187,0,36284
686,13608,14835,79,66,13542,2056286,40204,0,36254
687,13615,21104,73,94,13521,2048797,40253,0,36226
688,13588,13294,67,85,13503,2049091,40306,0,36191
689,13590,8456,87,51,13539,2054225,40304,0,36157
690,13613,13880,74,87,13526,2053958,40347,0,36127
691,13596,11909,70,75,13521,2055645,40379,0,36100
692,13588,7038,67,46,13542,2062195,40391,0,36067
693,13611,21774,69,83,13528,2054032,40442,0,36030
694,13607,18460,79,105,13502,2049179,40508,0,35990
695,13585,13883,83,91,13494,2048881,40556,0,35950
696,13556,19329,62,96,13460,2043108,40612,0,35928
697,13520,14455,60,68,13452,2042173,40647,0,35901
698,13536,4947,84,39,13497,2050762,40642,0,35861
699,13571,6801,74,54,13517,2057532,40644,0,35839
700,13593,5328,76,43,13550,2065797,40642,0,35808
701,13625,11771,75,66,13559,2067651,40666,0,35775
702,13624,13907,65,83,13541,2067368,40709,0,35750
703,13623,7328,82,46,13577,2073663,40709,0,35714
704,13662,18894,85,103,13559,2068431,40767,0,35674
705,13626,18847,67,96,13530,2063210,40832,0,35638
706,13622,8575,92,60,13562,2068257,40846,0,35592
707,13636,7834,74,58,13578,2074059,40870,0,35552
708,13651,19420,73,122,13529,2068290,40953,0,35518
709,13589,3316,60,22,13567,2078563,40937,0,35496
710,13636,17180,69,107,13529,2075019,41001,0,35470
711,13609,8220,80,62,13547,2080408,41022,0,35431
712,13627,20031,80,123,13504,2074004,41096,0,35400
713,13599,5588,95,39,13560,2082015,41086,0,35354
714,13633,15159,73,73,13560,2080489,41123,0,35317
715,13648,19327,88,105,13543,2074810,41178,0,35279
716,13611,10620,68,49,13562,2077801,41190,0,35248
717,13644,20283,82,113,13531,2071162,41260,0,35209
718,13600,11071,69,55,13545,2073691,41276,0,35179
719,13634,21051,89,125,13509,2066274,41361,0,35130
720,13592,12710,83,69,13523,2067156,41378,0,35099
721,13582,17544,59,98,13484,2063194,41440,0,35076
722,13560,11520,76,81,13479,2065234,41477,0,35044
723,13573,6502,94,43,13530,2072305,41460,0,35010
724,13608,11018,78,63,13545,2074895,41483,0,34972
725,13620,6190,75,36,13584,2082325,41478,0,34938
726,13650,13385,66,80,13570,2082590,41520,0,34910
727,13633,16708,63,85,13548,2079515,41578,0,34874
728,13634,19799,86,121,13513,2073350,41654,0,34833
729,13592,3325,79,27,13565,2083617,41632,0,34803
730,13632,16014,67,105,13527,2081235,41699,0,34774
731,13590,3605,63,31,13559,2091220,41698,0,34743
732,13644,15765,85,84,13560,2089099,41740,0,34700
733,13630,9259,70,50,13580,2093470,41758,0,34662
734,13654,31052,74,168,13486,2076072,41889,0,34625
735,13565,10865,79,69,13496,2078772,41915,0,34589
736,13562,7732,66,58,13504,2084602,41933,0,34563
737,13572,21966,68,122,13450,2076208,42012,0,34538
738,13527,6560,77,44,13483,2083175,42020,0,34497
739,13560,12894,77,65,13495,2083841,42044,0,34461
740,13564,15718,69,89,13475,2081687,42089,0,34436
741,13533,19847,58,108,13425,2075373,42168,0,34407
742,13514,7078,89,43,13471,2081809,42164,0,34365
743,13541,19305,70,91,13450,2076045,42229,0,34321
744,13515,12162,65,65,13450,2077398,42252,0,34298
745,13519,9286,69,58,13461,2081631,42269,0,34270
746,13528,15685,67,110,13418,2079474,42343,0,34239
747,13495,17880,77,98,13397,2075089,42397,0,34206
748,13487,16195,90,82,13405,2072381,42428,0,34167
749,13489,12477,84,70,13419,2073393,42458,0,34123
750,13496,40359,77,210,13286,2046530,42622,0,34092
751,13358,8282,72,44,13314,2051606,42623,0,34063
752,13399,7753,85,40,13359,2057252,42619,0,34022
753,13424,13323,65,86,13338,2057353,42670,0,33992
754,13408,21789,70,109,13299,2048972,42741,0,33960
755,13373,8239,74,51,13322,2054106,42754,0,33924
756,13397,26685,75,125,13272,2040818,42845,0,33883
757,13333,6828,61,49,13284,2047323,42859,0,33857
758,13366,10776,82,56,13310,2049913,42874,0,33816
759,13400,10550,90,52,13348,2052763,42875,0,33777
760,13408,4021,60,24,13384,2062150,42867,0,33749
761,13458,14072,74,85,13373,2061536,42901,0,33726
762,13443,12774,70,66,13377,2062205,42931,0,33692
763,13452,6109,75,32,13420,2069548,42928,0,33652
764,13487,17789,67,99,13388,2065246,42994,0,33618
765,13470,13732,82,65,13405,2064984,43009,0,33586
766,13480,4017,75,20,13460,2074447,42994,0,33546
767,13529,5379,69,45,13484,2082597,42999,0,33517
768,13560,10217,76,54,13506,2085940,43012,0,33482
769,13576,7059,70,41,13535,2092457,43008,0,33457
770,13608,8621,73,49,13559,2097444,43013,0,33428
771,13648,7960,89,43,13605,2103132,43014,0,33381
772,13685,25998,80,136,13549,2090819,43107,0,33344
773,13627,7789,78,41,13586,2096657,43095,0,33319
774,13666,8713,80,56,13610,2101610,43106,0,33284
775,13682,16597,72,113,13569,2098695,43177,0,33254
776,13641,16963,72,90,13551,2095373,43231,0,33218
777,13628,9161,77,58,13570,2099840,43239,0,33191
778,13642,21943,72,112,13530,2091539,43312,0,33158
779,13612,13327,82,77,13535,2091824,43335,0,33130
780,13607,14426,72,84,13523,2091005,43379,0,33098
781,13607,8047,84,45,13562,2096565,43373,0,33065
782,13644,10862,82,54,13590,2099347,43388,0,33022
783,13681,14368,91,76,13605,2098660,43405,0,32990
784,13688,5762,83,37,13651,2106586,43399,0,32950
785,13721,6685,70,37,13684,2113622,43387,0,32929
786,13739,10821,55,69,13670,2116540,43425,0,32905
787,13752,11905,82,67,13685,2118387,43448,0,32867
788,13758,27386,73,149,13609,2104759,43555,0,32836
789,13681,24730,72,121,13560,2093710,43631,0,32809
790,13649,21225,89,100,13549,2086134,43671,0,32780
791,13627,11915,78,67,13560,2087846,43693,0,32747
792,13637,8708,77,46,13591,2092775,43694,0,32715
793,13664,12711,73,80,13584,2093728,43736,0,32680
794,13674,8618,90,63,13611,2098784,43755,0,32634
795,13683,16808,72,80,13603,2095659,43786,0,32611
796,13679,13891,76,77,13602,2095447,43820,0,32578
797,13673,11367,71,75,13598,2097753,43857,0,32545
798,13692,11846,94,74,13618,2099599,43883,0,32499
799,13691,5661,73,37,13654,2107629,43880,0,32466
800,13732,10043,78,68,13664,2111318,43904,0,32432
801,13747,23351,83,108,13639,2101714,43965,0,32396
802,13712,20895,73,109,13603,2094531,44030,0,32367
803,13678,16273,75,85,13593,2091936,44075,0,32332
804,13678,23525,85,106,13572,2082089,44130,0,32298
805,13654,10182,82,73,13581,2085561,44158,0,32261
806,13658,27662,77,141,13517,2071557,44262,0,32221
807,13602,12997,85,103,13499,2072162,44304,0,32197
808,13589,16785,90,89,13500,2068966,44344,0,32156
809,13580,10942,80,73,13507,2071604,44373,0,32120
810,13599,10818,92,69,13530,2074385,44382,0,32088
811,13605,12200,75,60,13545,2075790,44399,0,32056
812,13636,11331,91,71,13565,2078095,44418,0,32017
813,13649,10489,84,53,13596,2081255,44425,0,31979
814,13678,12148,82,65,13613,2082785,44442,0,31945
815,13693,8006,80,53,13640,2088472,44445,0,31915
816,13724,3910,84,23,13701,2098286,44421,0,31878
817,13789,10141,88,58,13731,2101934,44425,0,31844
818,13803,27638,72,131,13672,2088099,44518,0,31810
819,13735,8016,63,49,13686,2093818,44533,0,31781
820,13772,18585,86,91,13681,2089005,44566,0,31753
821,13752,11150,71,77,13675,2091607,44607,0,31718
822,13758,16592,83,87,13671,2088773,44644,0,31685
823,13736,10481,65,76,13660,2092028,44682,0,31658
824,13728,13682,68,80,13648,2092074,44722,0,31630
825,13716,19374,68,95,13621,2086416,44783,0,31596
826,13678,20260,57,97,13581,2079834,44844,0,31575
827,13666,16108,85,92,13574,2077392,44881,0,31545
828,13643,13963,69,79,13564,2077072,44916,0,31520
829,13642,11737,78,58,13584,2078977,44931,0,31485
830,13656,18479,72,88,13568,2074154,44965,0,31467
831,13655,23506,87,120,13535,2064303,45036,0,31429
832,13620,1910,85,18,13602,2076013,45002,0,31396
833,13678,17442,76,97,13581,2072249,45067,0,31352
834,13652,12380,71,78,13574,2073521,45104,0,31322
835,13646,22783,72,140,13506,2064384,45196,0,31298
836,13589,12114,83,76,13513,2065859,45220,0,31267
837,13583,8765,70,62,13521,2070677,45239,0,31240
838,13592,12649,71,64,13528,2071620,45263,0,31209
839,13593,9235,65,55,13538,2075978,45282,0,31180
840,13630,7782,92,54,13576,2081826,45277,0,31147
841,13654,10656,78,56,13598,2084824,45282,0,31120
842,13683,27274,85,143,13540,2071233,45379,0,31081
843,13619,14690,79,76,13543,2070162,45407,0,31050
844,13612,19759,69,116,13496,2064015,45484,0,31020
845,13580,9363,84,58,13522,2068232,45491,0,30987
846,13606,21220,84,91,13515,2060618,45533,0,30952
847,13594,6456,79,42,13552,2067756,45527,0,30921
848,13628,15948,76,83,13545,2065436,45564,0,30891
849,13626,17857,81,91,13535,2061205,45608,0,30857
850,13626,21032,91,93,13533,2053799,45646,0,30821
851,13613,8057,80,68,13545,2059355,45677,0,30778
852,13614,4156,69,27,13587,2068813,45666,0,30747
853,13651,20274,64,112,13539,2062190,45744,0,30717
854,13602,12349,63,65,13537,2063443,45773,0,30690
855,13631,20110,94,122,13509,2056964,45838,0,30653
856,13579,26040,70,147,13432,2044503,45943,0,30625
857,13505,10889,73,68,13437,2047119,45963,0,30600
858,13531,14893,94,68,13463,2045757,45974,0,30563
859,13550,24173,87,117,13433,2035134,46039,0,30528
860,13508,10089,75,56,13452,2038553,46046,0,30502
861,13531,9617,79,59,13472,2042467,46062,0,30466
862,13540,13149,68,84,13456,2042858,46108,0,30436
863,13536,9050,80,59,13477,2047344,46115,0,30408
864,13563,12714,86,65,13498,2048193,46128,0,30374
865,13564,9678,66,55,13509,2052079,46150,0,30341
866,13579,15197,70,65,13514,2050461,46174,0,30312
867,13590,11555,76,72,13518,2052496,46205,0,30277
868,13595,8787,77,50,13545,2057304,46209,0,30246
869,13621,19313,76,99,13522,2051612,46269,0,30209
870,13594,21422,72,108,13486,2043784,46336,0,30178
871,13570,12325,84,63,13507,2045029,46351,0,30142
872,13593,13732,86,82,13511,2044890,46385,0,30104
873,13584,12906,73,88,13496,2045568,46430,0,30074
874,13553,5353,57,26,13527,2053768,46421,0,30052
875,13603,15040,76,87,13516,2052331,46458,0,30026
876,13595,13664,79,71,13524,2052262,46485,0,29991
877,13602,14305,78,84,13518,2051559,46519,0,29963
878,13597,17182,79,107,13490,2047974,46585,0,29925
879,13566,22521,76,127,13439,2039019,46667,0,29894
880,13519,7816,80,35,13484,2044722,46647,0,29869
881,13541,13503,57,70,13471,2044760,46681,0,29848
882,13564,18775,93,82,13482,2039549,46702,0,29816
883,13572,5146,90,35,13537,2047975,46682,0,29781
884,13606,18281,69,108,13498,2043300,46749,0,29753
885,13580,14452,82,70,13510,2042428,46775,0,29715
886,13598,19285,88,103,13495,2036741,46824,0,29681
887,13583,11912,88,67,13516,2038412,46831,0,29653
888,13583,22552,67,114,13469,2029443,46904,0,29627
889,13553,6053,84,43,13510,2036943,46888,0,29602
890,13589,11953,79,69,13520,2038579,46901,0,29579
891,13595,18834,75,92,13503,2033340,46948,0,29549
892,13596,11915,93,59,13537,2035021,46952,0,29511
893,13601,14766,64,89,13512,2033856,47002,0,29486
894,13602,11799,90,60,13542,2035659,47006,0,29452
895,13618,13278,76,57,13561,2035999,47015,0,29424
896,13642,13514,81,74,13568,2036127,47035,0,29397
897,13634,7298,66,46,13588,2042463,47044,0,29368
898,13651,20632,63,117,13534,2035482,47120,0,29346
899,13610,18917,76,107,13503,2030175,47177,0,29320
900,13580,18169,77,98,13482,2025586,47228,0,29290
901,13554,20330,72,107,13447,2018810,47288,0,29265
902,13514,19137,67,106,13408,2013187,47347,0,29245
903,13506,10530,98,62,13444,2016163,47353,0,29203
904,13526,7612,82,43,13483,2022077,47349,0,29168
905,13565,6666,82,47,13518,2028976,47342,0,29140
906,13590,16217,72,82,13508,2026349,47374,0,29118
907,13595,5312,87,36,13559,2034632,47370,0,29071
908,13645,12719,86,75,13570,2035558,47391,0,29039
909,13655,25655,85,144,13511,2023558,47487,0,29002
910,13586,24505,75,136,13450,2012639,47583,0,28967
911,13537,10019,87,45,13492,2016157,47580,0,28928
912,13555,7385,63,42,13513,2022327,47582,0,28905
913,13589,17768,76,105,13484,2018148,47641,0,28875
914,13569,24873,85,128,13441,2006844,47719,0,28840
915,13512,6109,71,42,13470,2014247,47713,0,28817
916,13556,22028,86,154,13402,2005775,47814,0,28784
917,13479,20660,77,108,13371,1998594,47876,0,28753
918,13449,5607,78,29,13420,2006436,47857,0,28723
919,13494,8146,74,48,13446,2011784,47858,0,28696
920,13547,7777,101,56,13491,2017554,47850,0,28659
921,13572,12791,81,71,13501,2018335,47876,0,28623
922,13559,9245,58,53,13506,2022649,47891,0,28603
923,13580,9906,74,66,13514,2026323,47913,0,28573
924,13586,17415,72,103,13483,2022494,47976,0,28541
925,13556,13705,73,65,13491,2022345,47990,0,28519
926,13564,9300,73,63,13501,2026609,48015,0,28484
927,13592,8744,91,45,13547,2031457,48002,0,28451
928,13616,8027,69,59,13557,2037046,48023,0,28420
929,13636,11721,79,64,13572,2038961,48036,0,28392
930,13644,20495,72,120,13524,2032110,48116,0,28360
931,13598,11921,74,73,13525,2033787,48147,0,28328
932,13600,30548,75,143,13457,2016839,48238,0,28305
933,13528,14233,71,83,13445,2016134,48278,0,28277
934,13530,11923,85,57,13473,2017741,48278,0,28249
935,13547,20293,74,111,13436,2010995,48338,0,28226
936,13508,7125,72,42,13466,2017378,48341,0,28193
937,13558,9973,92,66,13492,2020963,48348,0,28160
938,13560,9738,68,73,13487,2024785,48378,0,28135
939,13563,13564,76,99,13464,2024784,48434,0,28102
940,13535,13005,71,76,13459,2025314,48462,0,28079
941,13544,17314,85,86,13458,2021544,48489,0,28053
942,13516,8988,58,67,13449,2026072,48515,0,28036
943,13523,22977,74,132,13391,2016618,48596,0,28013
944,13459,16814,68,89,13370,2013263,48639,0,27991
945,13453,16481,83,96,13357,2010235,48681,0,27962
946,13439,16056,82,96,13343,2007618,48720,0,27937
947,13419,13088,76,83,13336,2007949,48749,0,27915
948,13437,16275,101,93,13344,2005111,48771,0,27885
949,13425,11350,81,63,13362,2007186,48789,0,27849
950,13427,11171,65,51,13376,2009442,48802,0,27822
951,13457,9825,81,50,13407,2013074,48797,0,27796
952,13492,6814,85,42,13450,2019752,48783,0,27767
953,13516,3910,66,24,13492,2029358,48762,0,27746
954,13567,7209,75,47,13520,2035716,48765,0,27715
955,13594,18018,74,94,13500,2031292,48813,0,27687
956,13570,18941,70,102,13468,2025921,48865,0,27667
957,13547,24654,79,130,13417,2014814,48935,0,27648
958,13498,5914,81,43,13455,2022398,48921,0,27624
959,13529,14206,74,72,13457,2021721,48943,0,27600
960,13531,10319,74,87,13444,2024933,48976,0,27580
961,13521,14229,77,80,13441,2024225,49010,0,27549
962,13509,16906,68,104,13405,2020828,49067,0,27528
963,13479,7443,74,54,13425,2026864,49074,0,27501
964,13500,30972,75,176,13324,2009392,49204,0,27472
965,13398,5623,74,36,13362,2017167,49195,0,27443
966,13424,14912,62,91,13333,2015679,49238,0,27429
967,13406,12190,73,57,13349,2016895,49242,0,27409
968,13422,12636,73,67,13355,2017681,49260,0,27385
969,13408,16442,53,89,13319,2014647,49316,0,27365
970,13399,17728,80,69,13330,2010318,49333,0,27337
971,13413,10648,83,58,13355,2013083,49333,0,27312
972,13436,30496,81,142,13294,1996023,49419,0,27287
973,13368,24709,74,131,13237,1984682,49495,0,27268
974,13322,15321,85,79,13243,1982683,49523,0,27234
975,13318,13812,75,73,13245,1982189,49542,0,27213
976,13326,11326,81,67,13259,1984189,49555,0,27186
977,13332,5933,73,41,13291,1991588,49560,0,27149
978,13376,20794,85,113,13263,1984170,49621,0,27116
979,13328,13082,65,71,13257,1984416,49645,0,27098
980,13334,4701,77,35,13299,1993049,49625,0,27076
981,13372,14945,73,88,13284,1991476,49662,0,27054
982,13378,10898,94,54,13324,1993956,49658,0,27018
983,13385,17095,61,103,13282,1990246,49719,0,26999
984,13347,15018,65,92,13255,1988575,49766,0,26979
985,13322,8323,67,43,13279,1993574,49762,0,26959
986,13345,6105,66,39,13306,2000814,49750,0,26944
987,13384,13995,78,81,13303,2000203,49777,0,26920
988,13376,5878,73,41,13335,2007701,49765,0,26900
989,13406,9861,71,66,13340,2011246,49791,0,26869
990,13411,11713,71,79,13332,2012944,49822,0,26846
991,13412,10783,80,71,13341,2015573,49841,0,26818
992,13422,21054,81,121,13301,2007941,49903,0,26796
993,13380,9283,79,66,13314,2012038,49919,0,26767
994,13384,6218,70,35,13349,2019204,49904,0,26747
995,13436,13038,87,75,13361,2019602,49923,0,26716
996,13447,14619,86,87,13360,2018430,49955,0,26685
997,13443,5583,83,37,13406,2026290,49937,0,26657
998,13504,12169,98,78,13426,2027625,49951,0,26623
999,13503,18736,77,111,13392,2022392,50013,0,26595
1000,13468,9835,76,55,13413,2026025,50018,0,26569
1001,13477,5052,64,41,13436,2034450,50013,0,26551
1002,13500,12867,64,80,13420,2035083,50053,0,26527
1003,13499,29058,79,143,13356,2019524,50143,0,26501
1004,13439,8353,83,60,13379,2024610,50146,0,26475
1005,13452,7447,73,46,13406,2030615,50147,0,26447
1006,13469,7228,63,47,13422,2036856,50148,0,26430
1007,13502,15596,80,64,13438,2034762,50148,0,26414
1008,13511,12233,73,68,13443,2036040,50169,0,26388
1009,13515,6619,72,52,13463,2042936,50173,0,26364
1010,13537,9769,74,64,13473,2046704,50193,0,26334
1011,13552,12827,79,59,13493,2047429,50199,0,26308
1012,13557,13238,64,82,13475,2047748,50236,0,26289
1013,13546,23708,71,123,13423,2037586,50307,0,26270
1014,13504,7320,81,39,13465,2043770,50289,0,26246
1015,13543,6101,78,46,13497,2051212,50279,0,26224
1016,13577,14087,80,90,13487,2050702,50320,0,26193
1017,13569,10772,82,51,13518,2053499,50319,0,26163
1018,13613,7656,95,48,13565,2059456,50303,0,26132
1019,13645,11292,80,67,13578,2061809,50314,0,26108
1020,13660,19347,82,105,13555,2056122,50375,0,26070
1021,13638,5875,83,59,13579,2063885,50370,0,26051
1022,13650,26583,71,138,13512,2050952,50459,0,26029
1023,13596,6036,84,33,13563,2058512,50438,0,25999
1024,13633,9177,70,47,13586,2062968,50440,0,25974
1025,13658,17282,72,93,13565,2059344,50480,0,25955
1026,13634,8662,69,56,13578,2064316,50488,0,25934
1027,13646,14403,68,96,13550,2063559,50535,0,25915
1028,13623,9012,73,60,13563,2068170,50552,0,25885
1029,13634,21602,71,109,13525,2060202,50618,0,25857
1030,13602,8488,77,42,13560,2065316,50612,0,25828
1031,13644,18966,84,108,13536,2059994,50659,0,25805
1032,13608,7255,72,58,13550,2066347,50664,0,25786
1033,13623,17761,73,91,13532,2062209,50708,0,25760
1034,13616,30389,84,158,13458,2045436,50805,0,25737
1035,13524,14482,66,87,13437,2044478,50847,0,25716
1036,13517,10242,80,58,13459,2047753,50854,0,25687
1037,13539,13027,80,84,13455,2048265,50886,0,25659
1038,13525,7724,70,44,13481,2054066,50879,0,25640
1039,13549,11890,68,77,13472,2055725,50907,0,25621
1040,13554,9042,82,50,13504,2060237,50899,0,25597
1041,13580,9815,76,64,13516,2064002,50913,0,25571
1042,13587,20936,71,132,13455,2056653,50998,0,25547
1043,13536,8908,81,55,13481,2061281,50997,0,25522
1044,13554,24389,73,133,13421,2050446,51082,0,25497
1045,13495,9964,74,53,13442,2053977,51082,0,25476
1046,13527,2749,85,30,13497,2064755,51059,0,25444
1047,13586,6884,89,50,13536,2071457,51050,0,25414
1048,13621,13048,85,83,13538,2072030,51078,0,25384
1049,13605,10594,67,62,13543,2075041,51094,0,25363
1050,13616,6768,73,40,13576,2081889,51084,0,25340
1051,13652,9369,76,47,13605,2086172,51080,0,25315
1052,13690,18506,85,102,13588,2081356,51122,0,25290
1053,13666,11868,78,69,13597,2083154,51140,0,25263
1054,13668,18528,71,105,13563,2078294,51199,0,25238
1055,13648,15999,85,118,13530,2075943,51259,0,25211
1056,13610,7753,80,43,13567,2081800,51248,0,25185
1057,13633,21139,66,101,13532,2074294,51301,0,25167
1058,13599,8767,67,53,13546,2079126,51310,0,25144
1059,13612,4268,66,31,13581,2088470,51300,0,25119
1060,13664,10886,83,56,13608,2091248,51310,0,25082
1061,13673,14043,65,80,13593,2090878,51351,0,25056
1062,13692,7744,99,44,13648,2096826,51332,0,25020
1063,13711,9732,63,48,13663,2100805,51335,0,25002
1064,13748,15987,85,92,13656,2098566,51365,0,24979
1065,13740,6519,84,40,13700,2105787,51349,0,24951
1066,13766,25428,66,145,13621,2094125,51457,0,24922
1067,13703,10372,82,70,13633,2097456,51479,0,24888
1068,13730,21601,97,128,13602,2089585,51542,0,24856
1069,13664,8682,62,55,13609,2094567,51553,0,24838
1070,13673,9297,64,65,13608,2098943,51573,0,24819
1071,13677,4548,69,38,13639,2108072,51563,0,24798
1072,13712,6477,73,37,13675,2115307,51547,0,24778
1073,13741,5849,66,39,13702,2123199,51546,0,24752
1074,13779,18497,77,103,13676,2118481,51598,0,24726
1075,13751,17474,75,90,13661,2114758,51646,0,24693
1076,13737,4538,76,35,13702,2123957,51628,0,24670
1077,13779,10788,77,52,13727,2126948,51630,0,24643
1078,13794,15809,67,92,13702,2124933,51676,0,24622
1079,13757,28570,55,151,13606,2110120,51790,0,24604
1080,13689,16565,83,95,13594,2107244,51832,0,24574
1081,13654,13429,60,67,13587,2107469,51858,0,24555
1082,13673,14294,86,82,13591,2106848,51887,0,24522
1083,13666,8493,75,56,13610,2112021,51887,0,24503
1084,13686,9059,76,49,13637,2116648,51884,0,24479
1085,13729,22640,92,110,13619,2107737,51929,0,24452
1086,13689,21264,70,119,13570,2100162,52006,0,24424
1087,13663,7712,93,51,13612,2106113,51999,0,24389
1088,13681,17484,69,107,13574,2102310,52059,0,24367
1089,13634,6086,60,34,13600,2109858,52056,0,24344
1090,13686,22944,86,122,13564,2100600,52124,0,24312
1091,13634,17027,70,93,13541,2097207,52165,0,24294
1092,13613,26376,72,117,13496,2084444,52230,0,24274
1093,13582,15999,86,96,13486,2082027,52265,0,24249
1094,13577,16865,91,81,13496,2078739,52286,0,24218
1095,13571,9896,75,46,13525,2082414,52280,0,24195
1096,13588,7828,63,48,13540,2088174,52290,0,24170
1097,13621,11629,81,61,13560,2090166,52301,0,24139
1098,13644,9385,84,48,13596,2094425,52286,0,24118
1099,13674,15058,78,75,13599,2093041,52299,0,24102
1100,13676,20197,77,113,13563,2086520,52363,0,24074
