Step,mass_grown,mass_burnt,trees_grown,trees_burnt,trees_count,trees_mass,ashes_count,ashes_mass,empty_count
100,15264,12802,771,628,14636,250655,48792,0,26572
101,15398,15899,762,782,14616,250154,49078,0,26306
102,15351,14928,735,730,14621,250577,49306,0,26073
103,15366,12602,745,631,14735,253341,49462,0,25803
104,15508,15563,773,777,14731,253286,49761,0,25508
105,15462,16778,731,862,14600,251970,50149,0,25251
106,15321,15312,721,743,14578,251979,50394,0,25028
107,15308,15836,730,799,14509,251451,50696,0,24795
108,15230,16978,721,873,14357,249703,51100,0,24543
109,15107,16140,750,792,14315,248670,51386,0,24299
110,15069,15051,754,729,14340,248688,51601,0,24059
111,15101,17715,761,834,14267,246074,51905,0,23828
112,15048,14441,781,729,14319,246681,52117,0,23564
113,15115,14920,796,777,14338,246876,52324,0,23338
114,15146,12502,808,654,14492,249520,52416,0,23092
115,15257,18574,765,910,14347,246203,52795,0,22858
116,15113,16420,766,798,14315,244896,53044,0,22641
117,15043,16810,728,806,14237,243129,53316,0,22447
118,14956,13482,719,695,14261,244603,53504,0,22235
119,15044,14961,783,745,14299,244686,53710,0,21991
120,15030,14393,731,747,14283,245323,53938,0,21779
121,15059,14923,776,762,14297,245459,54156,0,21547
122,15104,12753,807,666,14438,247810,54241,0,21321
123,15218,12509,780,673,14545,250519,54348,0,21107
124,15302,16377,757,805,14497,249444,54590,0,20913
125,15251,16531,754,849,14402,248164,54906,0,20692
126,15164,13534,762,676,14488,249794,55045,0,20467
127,15254,16381,766,867,14387,248667,55363,0,20250
128,15121,15893,734,788,14333,247895,55627,0,20040
129,15082,17985,749,856,14226,244992,55938,0,19836
130,14992,12659,766,667,14325,247325,56017,0,19658
131,15086,16281,761,820,14266,246130,56243,0,19491
132,15022,14035,756,710,14312,247117,56379,0,19309
133,15053,18202,741,861,14192,243968,56715,0,19093
134,14976,15176,784,763,14213,243768,56887,0,18900
135,14928,13945,715,687,14241,244751,57048,0,18711
136,14949,11153,708,608,14341,248547,57113,0,18546
137,15148,15690,807,769,14379,248005,57285,0,18336
138,15119,17533,740,859,14260,245591,57579,0,18161
139,15053,17686,793,838,14215,242958,57829,0,17956
140,15007,11853,792,639,14368,246112,57863,0,17769
141,15138,13334,770,702,14436,247916,57987,0,17577
142,15151,13010,715,657,14494,250057,58089,0,17417
143,15248,15288,754,762,14486,250017,58282,0,17232
144,15255,15927,769,779,14476,249345,58463,0,17061
145,15153,13261,677,638,14515,251237,58577,0,16908
146,15260,18088,745,880,14380,248409,58888,0,16732
147,15125,16279,745,814,14311,247255,59118,0,16571
148,15056,15978,745,787,14269,246333,59329,0,16402
149,15028,15568,759,756,14272,245793,59502,0,16226
150,15006,15597,734,751,14255,245202,59658,0,16087
151,15022,16549,767,854,14168,243675,59911,0,15921
152,14881,13248,713,707,14174,245308,60063,0,15763
153,14884,10627,710,544,14340,249565,60032,0,15628
154,15107,9018,767,501,14606,255654,59919,0,15475
155,15293,14130,687,665,14628,256817,60033,0,15339
156,15379,15461,751,787,14592,256735,60231,0,15177
157,15375,13505,783,667,14708,258605,60270,0,15022
158,15502,14142,794,702,14800,259965,60346,0,14854
159,15536,14927,736,712,14824,260574,60478,0,14698
160,15608,16221,784,766,14842,259961,60602,0,14556
161,15630,16381,788,827,14803,259210,60782,0,14415
162,15607,14953,804,718,14889,259864,60846,0,14265
163,15653,22260,764,1038,14615,253257,61258,0,14127
164,15341,13459,726,649,14692,255139,61312,0,13996
165,15472,16027,780,813,14659,254584,61478,0,13863
166,15403,16671,744,821,14582,253316,61694,0,13724
167,15260,15540,678,741,14519,253036,61888,0,13593
168,15244,14285,725,719,14525,253995,62016,0,13459
169,15264,14691,739,757,14507,254568,62186,0,13307
170,15229,14141,722,672,14557,255656,62251,0,13192
171,15341,12387,784,600,14741,258610,62183,0,13076
172,15480,16995,739,808,14672,257095,62398,0,12930
173,15434,13520,762,676,14758,259009,62445,0,12797
174,15507,12182,749,584,14923,262334,62424,0,12653
175,15668,16256,745,795,14873,261746,62590,0,12537
176,15625,11021,752,581,15044,266350,62549,0,12407
177,15778,21187,734,1003,14775,260941,62942,0,12283
178,15541,18116,766,886,14655,258366,63200,0,12145
179,15407,17369,752,801,14606,256404,63355,0,12039
180,15352,16560,746,829,14523,255196,63545,0,11932
181,15233,15094,710,702,14531,255335,63663,0,11806
182,15277,21122,746,1032,14245,249490,64061,0,11694
183,14989,15887,744,782,14207,248592,64207,0,11586
184,14939,14122,732,678,14261,249409,64276,0,11463
185,15023,17289,762,852,14171,247143,64481,0,11348
186,14949,16160,778,824,14125,245932,64666,0,11209
187,14922,17011,797,811,14111,243843,64787,0,11102
188,14899,13487,788,711,14188,245255,64810,0,11002
189,14933,11824,745,591,14342,248364,64758,0,10900
190,15079,12168,737,643,14436,251275,64776,0,10788
191,15166,16826,730,841,14325,249615,64982,0,10693
192,15089,12222,764,621,14468,252482,64939,0,10593
193,15160,13826,692,693,14467,253816,65050,0,10483
194,15222,13595,755,664,14558,255443,65066,0,10376
195,15370,16994,812,831,14539,253819,65209,0,10252
196,15262,14003,723,731,14531,255078,65317,0,10152
197,15263,15316,732,763,14500,255025,65457,0,10043
198,15295,18875,795,875,14420,251445,65640,0,9940
199,15213,13367,793,682,14531,253291,65624,0,9845
200,15270,17008,739,781,14489,251553,65761,0,9750
201,15245,14956,756,715,14530,251842,65812,0,9658
202,15266,16759,736,773,14493,250349,65934,0,9573
203,15265,13652,772,681,14584,251962,65928,0,9488
204,15324,15346,740,757,14567,251940,66036,0,9397
205,15343,15822,776,728,14615,251461,66083,0,9302
206,15379,11381,764,606,14773,255459,66009,0,9218
207,15531,18617,758,887,14644,252373,66227,0,9129
208,15433,18508,789,895,14538,249298,66439,0,9023
209,15251,13334,713,705,14546,251215,66509,0,8945
210,15274,15291,728,795,14479,251198,66662,0,8859
211,15239,16500,760,790,14449,249937,66774,0,8777
212,15185,17844,736,895,14290,247278,67024,0,8686
213,15067,15511,777,772,14295,246834,67106,0,8599
214,15028,13416,733,682,14346,248446,67139,0,8515
215,15089,15417,743,764,14325,248118,67249,0,8426
216,15118,12463,793,639,14479,250773,67200,0,8321
217,15254,12206,775,620,14634,253821,67125,0,8241
218,15365,15218,731,732,14633,253968,67212,0,8155
219,15349,11594,716,574,14775,257723,67144,0,8081
220,15516,13219,741,646,14870,260020,67128,0,8002
221,15623,14588,753,728,14895,261055,67178,0,7927
222,15699,14946,804,762,14937,261808,67228,0,7835
223,15641,22927,704,1045,14596,254522,67646,0,7758
224,15336,14645,740,744,14592,255213,67730,0,7678
225,15350,15483,758,781,14569,255080,67824,0,7607
226,15333,17929,764,842,14491,252484,67975,0,7534
227,15241,13534,750,667,14574,254191,67969,0,7457
228,15301,16910,727,794,14507,252582,68113,0,7380
229,15304,16188,797,777,14527,251698,68170,0,7303
230,15274,17692,747,852,14422,249280,68346,0,7232
231,15152,11406,730,590,14562,253026,68277,0,7161
232,15340,17493,778,810,14530,250873,68385,0,7085
233,15309,16034,779,814,14495,250148,68497,0,7008
234,15314,10207,819,518,14796,255255,68273,0,6931
235,15552,18222,756,893,14659,252585,68474,0,6867
236,15394,16722,735,795,14599,251257,68605,0,6796
237,15402,14443,803,738,14664,252216,68619,0,6717
238,15392,18923,728,906,14486,248685,68855,0,6659
239,15263,14684,777,778,14485,249264,68935,0,6580
240,15215,18334,730,952,14263,246145,69230,0,6507
241,14945,15360,682,727,14218,245730,69341,0,6441
242,14985,15564,767,769,14216,245151,69413,0,6371
243,14991,16174,775,820,14171,243968,69539,0,6290
244,14901,14291,730,662,14239,244578,69538,0,6223
245,14995,13264,756,683,14312,246309,69523,0,6165
246,15072,13349,760,644,14428,248032,69467,0,6105
247,15205,15894,777,820,14385,247343,69577,0,6038
248,15168,15776,783,776,14392,246735,69617,0,5991
249,15124,14475,732,748,14376,247384,69685,0,5939
250,15175,13432,799,705,14470,249127,69652,0,5878
251,15287,14969,817,717,14570,249445,69605,0,5825
252,15342,16268,772,808,14534,248519,69704,0,5762
253,15294,17891,760,886,14408,245922,69883,0,5709
254,15155,16484,747,821,14334,244593,70017,0,5649
255,15100,13598,766,718,14382,246095,70026,0,5592
256,15139,15988,757,849,14290,245246,70184,0,5526
257,15098,17758,808,831,14267,242586,70258,0,5475
258,15012,17473,745,868,14144,240125,70436,0,5420
259,14882,11285,738,578,14304,243722,70334,0,5362
260,15076,12373,772,636,14440,246425,70268,0,5292
261,15161,15068,721,808,14353,246518,70415,0,5232
262,15123,16245,770,807,14316,245396,70506,0,5178
263,15087,13933,771,750,14337,246550,70538,0,5125
264,15074,17436,737,878,14196,244188,70727,0,5077
265,14935,12503,739,649,14286,246620,70683,0,5031
266,15084,14785,798,710,14374,246919,70661,0,4965
267,15140,16653,766,821,14319,245406,70770,0,4911
268,15060,17154,741,819,14241,243312,70896,0,4863
269,14993,12288,752,622,14371,246017,70808,0,4821
270,15116,14627,745,750,14366,246506,70873,0,4761
271,15142,14436,776,727,14415,247212,70869,0,4716
272,15161,11888,746,604,14557,250485,70776,0,4667
273,15354,16471,797,799,14555,249368,70837,0,4608
274,15266,14905,711,750,14516,249729,70916,0,4568
275,15235,12834,719,593,14642,252130,70832,0,4526
276,15390,15278,748,747,14643,252242,70870,0,4487
277,15385,16686,742,810,14575,250941,70977,0,4448
278,15287,18461,712,886,14401,247767,71194,0,4405
279,15142,18113,741,912,14230,244796,71404,0,4366
280,15040,13204,810,724,14316,246632,71365,0,4319
281,15057,15719,741,792,14265,245970,71454,0,4281
282,15014,16873,749,844,14170,244111,71593,0,4237
283,14941,12081,771,616,14325,246971,71479,0,4196
284,15081,20513,756,953,14128,241539,71710,0,4162
285,14877,11142,749,624,14253,245274,71622,0,4125
286,15004,16705,751,844,14160,243573,71765,0,4075
287,14944,13253,784,684,14260,245264,71708,0,4032
288,15001,12534,741,629,14372,247731,71643,0,3985
289,15085,14173,713,673,14412,248643,71645,0,3943
290,15180,18730,768,895,14285,245093,71804,0,3911
291,15078,13865,793,687,14391,246306,71743,0,3866
292,15125,14410,734,731,14394,247021,71780,0,3826
293,15136,14660,742,781,14355,247497,71858,0,3787
294,15196,16595,841,848,14348,246098,71904,0,3748
295,15111,10311,763,560,14551,250898,71744,0,3705
296,15280,15302,729,763,14517,250876,71818,0,3665
297,15275,14538,758,748,14527,251613,71850,0,3623
298,15292,14623,765,711,14581,252282,71834,0,3585
299,15357,14277,776,722,14635,253362,71813,0,3552
300,15389,14144,754,734,14655,254607,71829,0,3516
301,15401,14523,746,692,14709,255485,71813,0,3478
302,15511,16539,802,772,14739,254457,71822,0,3439
303,15492,18040,753,872,14620,251909,71980,0,3400
304,15355,14726,735,758,14597,252538,72031,0,3372
305,15337,12998,740,697,14640,254877,72031,0,3329
306,15370,14614,730,711,14659,255633,72039,0,3302
307,15391,14928,732,778,14613,256096,72124,0,3263
308,15362,13435,749,634,14728,258023,72039,0,3233
309,15481,14525,753,703,14778,258979,72021,0,3201
310,15497,15808,719,748,14749,258668,72082,0,3169
311,15463,13799,714,652,14811,260332,72048,0,3141
312,15623,16914,812,835,14788,259041,72100,0,3112
313,15531,18107,743,866,14665,256465,72253,0,3082
314,15408,18124,743,888,14520,253749,72425,0,3055
315,15237,13127,717,674,14563,255859,72404,0,3033
316,15366,9259,803,500,14866,261966,72131,0,3003
317,15608,13160,742,664,14944,264414,72086,0,2970
318,15634,17394,690,808,14826,262654,72225,0,2949
319,15571,20538,745,948,14623,257687,72465,0,2912
320,15397,16147,774,801,14596,256937,72524,0,2880
321,15377,17062,781,845,14532,255252,72615,0,2853
322,15274,14909,742,719,14555,255617,72621,0,2824
323,15309,16367,754,788,14521,254559,72681,0,2798
324,15247,13397,726,684,14563,256409,72667,0,2770
325,15288,22341,725,1016,14272,249356,72996,0,2732
326,15087,15786,815,790,14297,248657,73001,0,2702
327,15125,17804,828,856,14269,245978,73054,0,2677
328,15012,20169,743,963,14049,240821,73306,0,2645
329,14770,12651,721,657,14113,242940,73265,0,2622
330,14877,16867,764,836,14041,240950,73359,0,2600
331,14779,9394,738,525,14254,246335,73168,0,2578
332,15034,16135,780,800,14234,245234,73217,0,2549
333,14956,13642,722,679,14277,246548,73200,0,2523
334,15036,13625,759,694,14342,247959,73161,0,2497
335,15092,13494,750,669,14423,249557,73101,0,2476
336,15188,13955,765,716,14472,250790,73072,0,2456
337,15203,15931,731,782,14421,250062,73142,0,2437
338,15222,16406,801,806,14416,248878,73175,0,2409
339,15102,13936,686,661,14441,250044,73166,0,2393
340,15221,13935,780,667,14554,251330,73075,0,2371
341,15335,14868,781,744,14591,251797,73063,0,2346
342,15364,12696,773,699,14665,254465,73010,0,2325
343,15386,19991,721,910,14476,249860,73222,0,2302
344,15247,12061,771,619,14628,253046,73094,0,2278
345,15402,15860,774,831,14571,252588,73164,0,2265
346,15335,14420,764,782,14553,253503,73210,0,2237
347,15299,15726,746,766,14533,253076,73243,0,2224
348,15279,17321,746,798,14481,251034,73312,0,2207
349,15266,14964,785,725,14541,251336,73272,0,2187
350,15314,19208,773,941,14373,247442,73465,0,2162
351,15115,17743,742,864,14251,244814,73609,0,2140
352,14978,15949,727,808,14170,243843,73710,0,2120
353,14931,14874,761,699,14232,243900,73674,0,2094
354,14962,14813,730,744,14218,244049,73706,0,2076
355,14966,17124,748,806,14160,241891,73787,0,2053
356,14947,14257,787,711,14236,242581,73730,0,2034
357,14901,13893,665,747,14154,243589,73834,0,2012
358,14929,13181,775,667,14262,245337,73744,0,1994
359,15033,15439,771,776,14257,244931,73772,0,1971
360,15011,14479,754,744,14267,245463,73779,0,1954
361,15033,16110,766,783,14250,244386,73810,0,1940
362,15009,14802,759,761,14248,244593,73837,0,1915
363,15012,13927,764,701,14311,245678,73795,0,1894
364,15047,11884,736,579,14468,248841,73656,0,1876
365,15251,19766,783,947,14304,244326,73839,0,1857
366,15061,13831,757,676,14385,245556,73779,0,1836
367,15163,13135,778,678,14485,247584,73695,0,1820
368,15232,16801,747,805,14427,246015,73771,0,1802
369,15181,15277,754,765,14416,245919,73798,0,1786
370,15125,15739,709,738,14387,245305,73847,0,1766
371,15155,16974,768,834,14321,243486,73934,0,1745
372,15060,13973,739,675,14385,244573,73883,0,1732
373,15087,13130,702,661,14426,246530,73861,0,1713
374,15197,12823,771,680,14517,248904,73790,0,1693
375,15262,10631,745,571,14691,253535,73637,0,1672
376,15419,12866,728,618,14801,256088,73538,0,1661
377,15534,15398,733,770,14764,256224,73594,0,1642
378,15532,17323,768,834,14698,254433,73673,0,1629
379,15462,17166,764,756,14706,252729,73687,0,1607
380,15373,16459,667,827,14546,251643,73862,0,1592
381,15237,17384,691,822,14415,249496,74008,0,1577
382,15151,13827,736,720,14431,250820,74011,0,1558
383,15150,14183,719,697,14453,251787,74009,0,1538
384,15267,13954,814,720,14547,253100,73930,0,1523
385,15297,12501,750,665,14632,255896,73861,0,1507
386,15368,15993,736,785,14583,255271,73929,0,1488
387,15331,15481,748,779,14552,255121,73974,0,1474
388,15311,14446,759,711,14600,255986,73940,0,1460
389,15292,14457,692,733,14559,256821,73996,0,1445
390,15279,15667,720,753,14526,256433,74042,0,1432
391,15266,15691,740,777,14489,256008,74094,0,1417
392,15246,13601,757,671,14575,257653,74023,0,1402
393,15319,13850,744,728,14591,259122,74029,0,1380
394,15285,18312,694,862,14423,256095,74217,0,1360
395,15173,18726,750,901,14272,252542,74381,0,1347
396,15018,17950,746,831,14187,249610,74478,0,1335
397,14954,13582,767,676,14278,250982,74398,0,1324
398,15057,16305,779,813,14244,249734,74448,0,1308
399,14991,14615,747,733,14258,250110,74442,0,1300
400,15002,15534,744,740,14262,249578,74453,0,1285
401,15026,16965,764,821,14205,247639,74524,0,1271
402,14943,12734,738,639,14304,249848,74435,0,1261
403,15094,16320,790,767,14327,248622,74428,0,1245
404,15087,15753,760,757,14330,247956,74439,0,1231
405,15097,17199,767,840,14257,245854,74525,0,1218
406,14968,12469,711,625,14343,248353,74445,0,1212
407,15117,15547,774,780,14337,247923,74460,0,1203
408,15141,16201,804,787,14354,246863,74452,0,1194
409,15101,15967,747,753,14348,245997,74465,0,1187
410,15069,15237,721,750,14319,245829,74507,0,1174
411,15052,14710,733,763,14289,246171,74555,0,1156
412,15087,13733,798,701,14386,247525,74470,0,1144
413,15115,16949,729,829,14286,245691,74574,0,1140
414,15058,18507,772,914,14144,242242,74726,0,1130
415,14890,12723,746,647,14243,244409,74633,0,1124
416,14988,16752,745,799,14189,242645,74698,0,1113
417,14994,12419,805,617,14377,245220,74518,0,1105
418,15081,12576,704,629,14452,247725,74453,0,1095
419,15186,14936,734,718,14468,247975,74444,0,1088
420,15217,13326,749,696,14521,249866,74398,0,1081
421,15265,15047,744,678,14587,250084,74343,0,1070
422,15323,11400,736,602,14721,254007,74216,0,1063
423,15484,13002,763,662,14822,256489,74128,0,1050
424,15553,15396,731,777,14776,256646,74183,0,1041
425,15522,17296,746,877,14645,254872,74324,0,1031
426,15399,16779,754,811,14588,253492,74392,0,1020
427,15380,19492,792,957,14423,249380,74571,0,1006
428,15230,14127,807,739,14491,250483,74512,0,997
429,15299,16745,808,800,14499,249037,74509,0,992
430,15279,16861,780,777,14502,247455,74521,0,977
431,15264,15403,762,778,14486,247316,74551,0,963
432,15245,14093,759,708,14537,248468,74508,0,955
433,15338,15367,801,790,14548,248439,74506,0,946
434,15261,16032,713,780,14481,247668,74584,0,935
435,15239,14797,758,760,14479,248110,74592,0,929
436,15231,15164,752,707,14524,248177,74552,0,924
437,15271,14725,747,732,14539,248723,74540,0,921
438,15271,13374,732,686,14585,250620,74497,0,918
439,15390,15928,805,790,14600,250082,74492,0,908
440,15398,16612,798,849,14549,248868,74551,0,900
441,15312,15745,763,817,14495,248435,74614,0,891
442,15216,16059,721,763,14453,247592,74665,0,882
443,15213,15013,760,761,14452,247792,74673,0,875
444,15236,13504,784,684,14552,249524,74578,0,870
445,15348,16743,796,858,14490,248129,74647,0,863
446,15206,14810,716,756,14450,248525,74696,0,854
447,15200,16707,750,841,14359,247018,74796,0,845
448,15107,19491,748,972,14135,242634,75029,0,836
449,14905,13945,770,675,14230,243594,74940,0,830
450,15008,11573,778,615,14393,247029,74788,0,819
451,15148,13169,755,721,14427,249008,74765,0,808
452,15241,17510,814,843,14398,246739,74803,0,799
453,15165,12395,767,617,14548,249509,74662,0,790
454,15263,14375,715,724,14539,250397,74679,0,782
455,15343,14303,804,710,14633,251437,74594,0,773
456,15384,17010,751,834,14550,249811,74686,0,764
457,15307,13200,757,680,14627,251918,74617,0,756
458,15387,12334,760,611,14776,254971,74477,0,747
459,15490,15409,714,722,14768,255052,74490,0,742
460,15519,13612,751,686,14833,256959,74430,0,737
461,15580,15721,747,760,14820,256818,74452,0,728
462,15566,16812,746,851,14715,255572,74565,0,720
463,15495,15015,780,794,14701,256052,74582,0,717
464,15481,16295,780,775,14706,255238,74585,0,709
465,15469,14445,763,731,14738,256262,74559,0,703
466,15484,17099,746,815,14669,254647,74635,0,696
467,15401,16231,732,786,14615,253817,74695,0,690
468,15329,17572,714,826,14503,251574,74810,0,687
469,15276,13633,773,703,14573,253217,74743,0,684
470,15321,16391,748,809,14512,252147,74808,0,680
471,15267,12644,755,639,14628,254770,74701,0,671
472,15409,14811,781,692,14717,255368,74617,0,666
473,15442,17300,725,808,14634,253510,74704,0,662
474,15394,13503,760,670,14724,255401,74625,0,651
475,15472,17499,748,829,14643,253374,74717,0,640
476,15430,16681,787,798,14632,252123,74737,0,631
477,15349,13659,717,690,14659,253813,74715,0,626
478,15470,13592,811,686,14784,255691,74595,0,621
479,15539,15400,755,762,14777,255830,74609,0,614
480,15532,14541,755,765,14767,256821,74623,0,610
481,15500,17201,733,823,14677,255120,74721,0,602
482,15438,12780,761,659,14779,257778,74624,0,597
483,15537,18933,758,884,14653,254382,74758,0,589
484,15424,16583,771,795,14629,253223,74787,0,584
485,15353,17657,724,891,14462,250919,74960,0,578
486,15256,16687,794,814,14442,249488,74984,0,574
487,15228,19830,786,935,14293,244886,75134,0,573
488,15075,15091,782,711,14364,244870,75071,0,565
489,15117,14919,753,730,14387,245068,75051,0,562
490,15124,15415,737,737,14387,244777,75058,0,555
491,15196,14478,809,733,14463,245495,74990,0,547
492,15249,14755,786,730,14519,245989,74939,0,542
493,15331,16712,812,862,14469,244608,74993,0,538
494,15184,13285,715,660,14524,246507,74945,0,531
495,15288,15573,764,778,14510,246222,74962,0,528
496,15254,17839,744,848,14406,243637,75075,0,519
497,15140,16352,734,808,14332,242425,75151,0,517
498,15061,17949,729,869,14192,239537,75299,0,509
499,15005,13982,813,714,14291,240560,75202,0,507
500,15060,12969,769,678,14382,242651,75115,0,503
501,15112,12076,730,668,14444,245687,75058,0,498
502,15195,13411,751,666,14529,247471,74980,0,491
503,15272,19412,743,921,14351,243331,75162,0,487
504,15129,13578,778,692,14437,244882,75077,0,486
505,15207,16859,770,806,14401,243230,75118,0,481
506,15195,16659,794,844,14351,241766,75172,0,477
507,15132,12479,781,669,14463,244419,75065,0,472
508,15223,11850,760,611,14612,247792,74920,0,468
509,15365,16120,753,809,14556,247037,74982,0,462
510,15269,19483,713,975,14294,242823,75247,0,459
511,15030,14636,736,768,14262,243217,75283,0,455
512,15020,15180,758,750,14270,243057,75279,0,451
513,14995,13216,725,678,14317,244836,75236,0,447
514,15069,11235,752,641,14428,248670,75129,0,443
515,15169,11388,741,581,14588,252451,74973,0,439
516,15339,17637,751,838,14501,250153,75061,0,438
517,15235,16291,734,842,14393,249097,75177,0,430
518,15129,17518,736,894,14235,246708,75338,0,427
519,14977,17653,742,820,14157,244032,75420,0,423
520,14936,11991,779,584,14352,246977,75231,0,417
521,15123,10429,771,579,14544,251671,75043,0,413
522,15336,12499,792,667,14669,254508,74923,0,408
523,15472,16239,803,798,14674,253741,74921,0,405
524,15413,17193,739,873,14540,251961,75057,0,403
525,15313,14633,773,718,14595,252641,75007,0,398
526,15329,18737,734,903,14426,249233,75177,0,397
527,15185,16188,759,807,14378,248230,75230,0,392
528,15119,15538,741,807,14312,247811,75303,0,385
529,15070,13504,758,686,14384,249377,75234,0,382
530,15129,10298,745,536,14593,254208,75027,0,380
531,15415,12686,822,657,14758,256937,74868,0,374
532,15502,15163,744,773,14729,257276,74900,0,371
533,15482,14508,753,735,14747,258250,74883,0,370
534,15518,15866,771,841,14677,257902,74955,0,368
535,15405,16061,728,766,14639,257246,74996,0,365
536,15368,14212,729,763,14605,258402,75032,0,363
537,15326,18366,721,868,14458,255362,75184,0,358
538,15188,14439,730,766,14422,256111,75221,0,357
539,15183,14890,761,693,14490,256404,75154,0,356
540,15299,19321,809,911,14388,252382,75264,0,348
541,15139,14037,751,691,14448,253484,75207,0,345
542,15190,18768,742,862,14328,249906,75329,0,343
543,15073,15046,745,778,14295,249933,75369,0,336
544,15087,12667,792,654,14433,252353,75233,0,334
545,15167,13213,734,660,14507,254307,75160,0,333
546,15303,14457,796,705,14598,255153,75072,0,330
547,15348,12943,750,656,14692,257558,74982,0,326
548,15453,15596,761,783,14670,257415,75011,0,319
549,15400,15803,730,812,14588,257012,75094,0,318
550,15395,16891,807,835,14560,255516,75126,0,314
551,15281,14562,721,726,14555,256235,75134,0,311
552,15334,16567,779,760,14574,255002,75116,0,310
553,15324,17400,750,812,14512,252926,75180,0,308
554,15300,13597,788,643,14657,254629,75037,0,306
555,15432,13455,775,669,14763,256606,74936,0,301
556,15500,14296,737,689,14811,257810,74891,0,298
557,15614,15443,803,777,14837,257981,74871,0,292
558,15604,15926,767,756,14848,257659,74862,0,290
559,15588,14909,740,751,14837,258338,74879,0,284
560,15616,17798,779,827,14789,256156,74927,0,284
561,15552,14484,763,638,14914,257224,74804,0,282
562,15641,15508,727,786,14855,257357,74867,0,278
563,15620,14188,765,702,14918,258789,74807,0,275
564,15671,13796,753,722,14949,260664,74778,0,273
565,15712,15689,763,774,14938,260687,74795,0,267
566,15687,14773,749,707,14980,261601,74757,0,263
567,15750,14926,770,755,14995,262425,74746,0,259
568,15753,13719,758,697,15056,264459,74687,0,257
569,15819,21023,763,984,14835,259255,74910,0,255
570,15622,16156,787,800,14822,258721,74924,0,254
571,15511,20913,689,991,14520,253319,75227,0,253
572,15284,16693,764,859,14425,251910,75325,0,250
573,15215,14665,790,712,14503,252460,75247,0,250
574,15256,15459,753,808,14448,252257,75303,0,249
575,15196,15448,748,766,14430,252005,75324,0,246
576,15192,16790,762,816,14376,250407,75382,0,242
577,15148,15393,772,799,14349,250162,75412,0,239
578,15133,16738,784,805,14328,248557,75435,0,237
579,15057,14954,729,720,14337,248660,75429,0,234
580,15087,14929,750,715,14372,248818,75398,0,230
581,15127,13507,755,691,14436,250438,75335,0,229
582,15236,14584,800,762,14474,251090,75300,0,226
583,15156,15748,682,781,14375,250498,75400,0,225
584,15175,15713,800,758,14417,249960,75360,0,223
585,15145,16535,728,792,14353,248570,75425,0,222
586,15143,16606,790,788,14355,247107,75430,0,215
587,15114,17331,759,855,14259,244890,75529,0,212
588,15027,12426,768,636,14391,247491,75398,0,211
589,15142,13129,751,660,14482,249504,75308,0,210
590,15231,14713,749,688,14543,250022,75248,0,209
591,15301,15496,758,768,14533,249827,75261,0,206
592,15269,17559,736,864,14405,247537,75390,0,205
593,15180,16056,775,739,14441,246661,75356,0,203
594,15170,14759,729,741,14429,247072,75371,0,200
595,15217,13672,788,685,14532,248617,75268,0,200
596,15293,13073,761,684,14609,250837,75194,0,197
597,15354,18271,745,860,14494,247920,75315,0,191
598,15259,15743,765,768,14491,247436,75319,0,190
599,15177,13359,686,674,14503,249254,75311,0,186
600,15242,16295,739,763,14479,248201,75339,0,182
601,15195,15561,716,768,14427,247835,75392,0,181
602,15155,17262,728,841,14314,245728,75505,0,181
603,15018,11162,704,603,14415,249584,75406,0,179
604,15192,11254,777,600,14592,253522,75230,0,178
605,15330,13800,738,727,14603,255052,75222,0,175
606,15324,13703,721,729,14595,256673,75231,0,174
607,15325,18734,730,885,14440,253264,75390,0,170
608,15185,15974,745,781,14404,252475,75427,0,169
609,15143,16940,739,834,14309,250678,75523,0,168
610,15105,14816,796,733,14372,250967,75464,0,164
611,15150,15088,778,710,14440,251029,75400,0,160
612,15192,17802,752,859,14333,248419,75508,0,159
613,15087,13449,754,696,14391,250057,75450,0,159
614,15140,13866,749,734,14406,251331,75436,0,158
615,15146,16175,740,809,14337,250302,75507,0,156
616,15081,16572,744,869,14212,248811,75632,0,156
617,14988,17053,776,825,14163,246746,75682,0,155
618,14903,11177,740,595,14308,250472,75538,0,154
619,15075,14054,767,724,14351,251493,75496,0,153
620,15081,16104,730,744,14337,250470,75511,0,152
621,15052,15252,715,742,14310,250270,75541,0,149
622,15131,14513,821,728,14403,250888,75452,0,145
623,15135,16225,732,728,14407,249798,75448,0,145
624,15155,14446,748,691,14464,250507,75392,0,144
625,15167,11681,703,629,14538,253993,75320,0,142
626,15288,16138,750,773,14515,253143,75344,0,141
627,15247,13760,732,742,14505,254630,75355,0,140
628,15206,15315,701,764,14442,254521,75420,0,138
629,15166,14568,724,720,14446,255119,75418,0,136
630,15153,19146,707,853,14300,251126,75565,0,135
631,15026,12874,726,672,14354,253278,75511,0,135
632,15155,15825,801,787,14368,252608,75498,0,134
633,15153,15411,785,712,14441,252350,75427,0,132
634,15167,14956,726,702,14465,252561,75404,0,131
635,15168,17160,703,848,14320,250569,75552,0,128
636,15046,14513,726,698,14348,251102,75525,0,127
637,15065,13168,717,684,14381,252999,75492,0,127
638,15177,14921,796,776,14401,253255,75473,0,126
639,15158,18463,757,859,14299,249950,75578,0,123
640,15060,13254,761,666,14394,251756,75484,0,122
641,15124,14730,730,722,14402,252150,75476,0,122
642,15162,17895,760,862,14300,249417,75580,0,120
643,15098,16855,798,865,14233,247660,75649,0,118
644,15023,13791,790,675,14348,248892,75535,0,117
645,15111,14157,763,702,14409,249846,75474,0,117
646,15203,14044,794,709,14494,251005,75391,0,115
647,15280,16363,786,746,14534,249922,75352,0,114
648,15270,9540,736,530,14740,255652,75146,0,114
649,15471,16113,731,796,14675,255010,75211,0,114
650,15470,15780,795,771,14699,254700,75187,0,114
651,15449,18448,750,912,14537,251701,75351,0,112
652,15339,16488,802,743,14596,250552,75292,0,112
653,15349,11329,753,618,14731,254572,75158,0,111
654,15427,15514,696,781,14646,254485,75244,0,110
655,15430,17727,784,863,14567,252188,75325,0,108
656,15309,16899,742,821,14488,250598,75405,0,107
657,15232,14903,744,783,14449,250927,75444,0,107
658,15209,15055,760,772,14437,251081,75456,0,107
659,15164,14425,727,742,14422,251820,75471,0,107
660,15173,14150,751,674,14499,252843,75394,0,107
661,15290,11996,791,630,14660,256137,75233,0,107
662,15431,17099,771,791,14640,254469,75254,0,106
663,15359,16309,719,791,14568,253519,75326,0,106
664,15310,16407,742,795,14515,252422,75380,0,105
665,15271,16376,756,821,14450,251317,75447,0,103
666,15190,14165,740,697,14493,252342,75407,0,100
667,15308,19622,815,900,14408,248028,75493,0,99
668,15196,14072,788,666,14530,249152,75372,0,98
669,15266,14966,736,743,14523,249452,75382,0,95
670,15305,12995,782,643,14662,251762,75243,0,95
671,15387,13313,725,642,14745,253836,75161,0,94
672,15483,11408,738,551,14932,257911,74975,0,93
673,15689,15187,757,724,14965,258413,74945,0,90
674,15712,14986,747,757,14955,259139,74955,0,90
675,15734,17882,779,864,14870,256991,75041,0,89
676,15636,18232,766,916,14720,254395,75194,0,86
677,15485,17654,765,877,14608,252226,75307,0,85
678,15359,14491,751,717,14642,253094,75273,0,85
679,15409,20615,767,994,14415,247888,75500,0,85
680,15199,12709,784,654,14545,250378,75371,0,84
681,15285,16672,740,795,14490,248991,75427,0,83
682,15222,16921,732,847,14375,247292,75544,0,81
683,15157,12682,782,649,14508,249767,75411,0,81
684,15257,14993,749,749,14508,250031,75412,0,80
685,15235,14203,727,729,14506,251063,75415,0,79
686,15226,14076,720,715,14511,252213,75410,0,79
687,15250,13408,739,662,14588,254055,75333,0,79
688,15303,16270,715,794,14509,253088,75412,0,79
689,15297,20251,788,1005,14292,248134,75629,0,79
690,14993,12706,701,624,14369,250421,75552,0,79
691,15125,11971,756,624,14501,253575,75420,0,79
692,15263,13114,762,669,14594,255724,75328,0,78
693,15369,16099,775,805,14564,254994,75358,0,78
694,15343,15672,779,782,14561,254665,75361,0,78
695,15295,13924,734,715,14580,256036,75343,0,77
696,15308,17990,728,852,14456,253354,75468,0,76
697,15198,14610,742,721,14477,253942,75447,0,76
698,15204,16935,727,834,14370,252211,75554,0,76
699,15090,13196,720,640,14450,254105,75475,0,75
700,15186,17639,736,844,14342,251652,75584,0,74
701,15145,14089,803,742,14403,252708,75525,0,72
702,15146,12983,743,667,14479,254871,75450,0,71
703,15192,17182,713,802,14390,252881,75539,0,71
704,15139,17414,749,841,14298,250606,75631,0,71
705,15074,14443,776,729,14345,251237,75584,0,71
706,15111,15500,766,762,14349,250848,75580,0,71
707,15156,14668,807,677,14479,251336,75452,0,69
708,15267,21473,788,983,14284,245130,75648,0,68
709,15026,14330,742,733,14293,245826,75639,0,68
710,15041,8186,748,465,14576,252681,75357,0,67
711,15321,14874,745,734,14587,253128,75347,0,66
712,15322,14751,735,735,14587,253699,75347,0,66
713,15372,16006,785,784,14588,253065,75348,0,64
714,15321,14710,733,745,14576,253676,75360,0,64
715,15317,18381,741,905,14412,250612,75526,0,62
716,15117,14193,705,685,14432,251536,75506,0,62
717,15177,14006,745,728,14449,252707,75489,0,62
718,15236,14475,787,710,14526,253468,75415,0,59
719,15268,16031,742,792,14476,252705,75465,0,59
720,15175,13868,699,658,14517,254012,75424,0,59
721,15299,16896,782,823,14476,252415,75465,0,59
722,15250,14093,774,707,14543,253572,75398,0,59
723,15295,20780,752,975,14320,248087,75621,0,59
724,15017,13585,697,693,14324,249519,75617,0,59
725,15034,13565,710,679,14355,250988,75587,0,58
726,15166,18074,811,882,14284,248080,75659,0,57
727,15100,12702,816,671,14429,250478,75514,0,57
728,15163,14616,734,695,14468,251025,75478,0,54
729,15234,16913,766,821,14413,249346,75535,0,52
730,15162,17383,749,856,14306,247125,75642,0,52
731,15088,15340,782,778,14310,246873,75639,0,51
732,15070,14237,760,707,14363,247706,75588,0,49
733,15080,17416,717,818,14262,245370,75689,0,49
734,14993,13782,731,712,14281,246581,75670,0,49
735,15034,10912,753,583,14451,250703,75501,0,48
736,15227,16602,776,841,14386,249328,75567,0,47
737,15136,13632,750,637,14499,250832,75454,0,47
738,15294,12068,795,598,14696,254058,75259,0,45
739,15409,15551,713,733,14676,253916,75279,0,45
740,15482,11938,806,600,14882,257460,75073,0,45
741,15618,18493,736,874,14744,254585,75213,0,43
742,15497,13409,753,674,14823,256673,75135,0,42
743,15549,15863,726,817,14732,256359,75227,0,41
744,15412,17647,680,865,14547,254124,75412,0,41
745,15327,16583,780,847,14480,252868,75479,0,41
746,15249,15578,769,728,14521,252539,75438,0,41
747,15274,15848,753,814,14460,251965,75499,0,41
748,15177,16902,717,841,14336,250240,75623,0,41
749,15118,13780,782,687,14431,251578,75528,0,41
750,15207,16369,776,780,14427,250416,75533,0,40
751,15158,13856,731,717,14441,251718,75519,0,40
752,15183,14494,742,746,14437,252407,75523,0,40
753,15204,12863,767,640,14564,254748,75396,0,40
754,15295,15872,731,773,14522,254171,75440,0,38
755,15285,17504,763,887,14398,251952,75565,0,37
756,15164,13614,766,699,14465,253502,75498,0,37
757,15221,14909,756,703,14518,253814,75445,0,37
758,15281,17252,763,842,14439,251843,75524,0,37
759,15212,15640,773,751,14461,251415,75504,0,35
760,15220,17287,759,803,14417,249348,75548,0,35
761,15147,14295,730,687,14460,250200,75505,0,35
762,15236,15668,776,775,14461,249768,75505,0,34
763,15245,17911,784,878,14367,247102,75599,0,34
764,15154,16333,787,820,14334,245923,75632,0,34
765,15089,18071,755,876,14213,242941,75753,0,34
766,14959,14361,746,733,14226,243539,75740,0,34
767,14957,13149,731,648,14309,245347,75657,0,34
768,15097,17429,788,847,14250,243015,75717,0,33
769,14987,11653,737,632,14355,246349,75612,0,33
770,15131,12557,776,643,14488,248923,75479,0,33
771,15312,11949,824,601,14711,252286,75259,0,30
772,15476,17049,765,793,14683,250713,75288,0,29
773,15443,15319,760,742,14701,250837,75272,0,27
774,15441,13580,740,666,14775,252698,75199,0,26
775,15523,14068,748,711,14812,254153,75162,0,26
776,15502,19655,690,957,14545,250000,75429,0,26
777,15296,12241,751,621,14675,253055,75299,0,26
778,15422,16736,747,794,14628,251741,75346,0,26
779,15313,14026,685,707,14606,253028,75369,0,25
780,15318,13701,712,691,14627,254645,75348,0,25
781,15349,15350,722,760,14589,254644,75386,0,25
782,15342,15687,753,802,14540,254299,75435,0,25
783,15308,17107,768,848,14460,252500,75515,0,25
784,15203,17184,743,866,14337,250519,75638,0,25
785,15085,11842,748,561,14524,253762,75451,0,25
786,15280,13497,756,679,14601,255545,75374,0,25
787,15389,14542,788,752,14637,256392,75338,0,25
788,15391,16076,754,741,14650,255707,75325,0,25
789,15417,16777,767,804,14613,254347,75362,0,25
790,15347,13551,734,654,14693,256143,75283,0,24
791,15479,15601,786,750,14729,256021,75247,0,24
792,15502,17186,773,777,14725,254337,75251,0,24
793,15473,16281,748,817,14656,253529,75320,0,24
794,15435,18555,779,879,14556,250409,75420,0,24
795,15331,15249,775,797,14534,250491,75442,0,24
796,15319,13226,785,667,14652,252584,75324,0,24
797,15410,16392,758,833,14577,251602,75399,0,24
798,15364,13887,787,718,14646,253079,75330,0,24
799,15402,16011,756,788,14614,252470,75362,0,24
800,15370,13491,756,675,14695,254349,75281,0,24
801,15488,8743,793,480,15008,261094,74968,0,24
802,15705,14498,697,729,14976,262301,75000,0,24
803,15726,18806,750,923,14803,259221,75173,0,24
804,15588,20814,785,963,14625,253995,75351,0,24
805,15312,16764,687,819,14493,252543,75483,0,24
806,15246,15193,753,712,14534,252596,75442,0,24
807,15284,12149,750,612,14672,255731,75304,0,24
808,15439,15533,767,738,14701,255637,75275,0,24
809,15450,15018,749,713,14737,256069,75239,0,24
810,15451,14772,714,738,14713,256748,75263,0,24
811,15426,13163,713,653,14773,259011,75203,0,24
812,15517,18561,744,953,14564,255967,75412,0,24
813,15294,14632,730,718,14576,256629,75401,0,23
814,15336,15030,760,765,14571,256935,75407,0,22
815,15298,15121,727,757,14541,257112,75438,0,21
816,15349,20366,808,905,14444,252095,75535,0,21
817,15235,15664,791,775,14460,251666,75520,0,20
818,15174,13868,714,700,14474,252972,75506,0,20
819,15219,14978,745,736,14483,253213,75497,0,20
820,15194,16554,711,789,14405,251853,75577,0,18
821,15161,15384,756,793,14368,251630,75614,0,18
822,15195,17504,827,831,14364,249321,75618,0,18
823,15134,16075,770,752,14382,248380,75600,0,18
824,15085,13757,703,709,14376,249708,75606,0,18
825,15109,13336,733,696,14413,251481,75569,0,18
826,15189,16763,776,830,14359,249907,75623,0,18
827,15082,15827,723,740,14342,249162,75640,0,18
828,15072,14054,730,687,14385,250180,75597,0,18
829,15119,15086,734,744,14375,250213,75607,0,18
830,15116,18211,741,872,14244,247118,75738,0,18
831,15013,13117,769,675,14338,249014,75645,0,17
832,15070,17897,732,844,14226,246187,75757,0,17
833,14924,16103,698,794,14130,245008,75853,0,17
834,14886,15941,756,741,14145,243953,75838,0,17
835,14947,16512,802,795,14152,242388,75831,0,17
836,14933,13638,781,660,14273,243683,75711,0,16
837,15026,14280,753,682,14344,244429,75640,0,16
838,15116,15473,772,746,14370,244072,75614,0,16
839,15084,16038,714,757,14327,243118,75657,0,16
840,15082,11952,755,624,14458,246248,75526,0,16
841,15223,14271,765,717,14506,247200,75478,0,16
842,15298,16420,792,783,14515,246078,75469,0,16
843,15265,12145,750,576,14689,249198,75296,0,15
844,15436,11531,747,624,14812,253103,75173,0,15
845,15509,15602,697,760,14749,253010,75236,0,15
846,15484,15873,735,771,14713,252621,75272,0,15
847,15454,14211,741,720,14734,253864,75251,0,15
848,15502,14038,768,714,14788,255328,75197,0,15
849,15517,15964,729,791,14726,254881,75260,0,14
850,15525,13632,799,684,14841,256774,75146,0,13
851,15614,15716,773,749,14865,256672,75122,0,13
852,15615,17480,750,852,14763,254807,75224,0,13
853,15498,14376,735,749,14749,255929,75238,0,13
854,15459,16983,710,856,14603,254405,75384,0,13
855,15406,16225,803,794,14612,253586,75375,0,13
856,15330,13872,718,734,14596,255044,75391,0,13
857,15348,14154,752,752,14596,256238,75391,0,13
858,15337,14047,741,681,14656,257528,75331,0,13
859,15406,16910,750,851,14555,256024,75433,0,12
860,15312,15362,757,716,14596,255974,75392,0,12
861,15323,15587,727,747,14576,255710,75413,0,11
862,15300,16947,724,806,14494,254063,75495,0,11
863,15229,17465,735,842,14387,251827,75602,0,11
864,15140,13745,753,686,14454,253222,75535,0,11
865,15212,18525,758,888,14324,249909,75665,0,11
866,15092,16671,768,798,14294,248330,75696,0,10
867,15042,13062,748,667,14375,250310,75615,0,10
868,15164,12810,789,657,14507,252664,75483,0,10
869,15228,14357,721,686,14542,253535,75448,0,10
870,15333,16809,791,770,14563,252059,75427,0,10
871,15277,12367,714,608,14669,254969,75321,0,10
872,15445,13751,776,683,14762,256663,75228,0,10
873,15482,20205,720,990,14492,251940,75498,0,10
874,15270,14590,778,730,14540,252620,75450,0,10
875,15274,14278,734,744,14530,253616,75460,0,10
876,15271,10990,741,561,14710,257897,75280,0,10
877,15437,21079,727,1009,14428,252255,75562,0,10
878,15159,18665,731,851,14308,248749,75682,0,10
879,15102,15838,794,788,14314,248013,75676,0,10
880,15093,13498,779,715,14378,249608,75612,0,10
881,15118,16741,740,819,14299,247985,75691,0,10
882,15077,15416,778,762,14315,247646,75675,0,10
883,15056,16205,741,800,14256,246497,75734,0,10
884,14998,10391,742,583,14415,251104,75575,0,10
885,15163,17338,748,870,14293,248929,75698,0,9
886,15061,16186,768,772,14289,247804,75702,0,9
887,15042,13296,753,644,14398,249550,75593,0,9
888,15165,16196,767,778,14387,248519,75604,0,9
889,15150,14293,763,782,14368,249376,75623,0,9
890,15149,15623,781,758,14391,248902,75600,0,9
891,15138,14570,747,703,14435,249470,75556,0,9
892,15186,14544,751,704,14482,250112,75509,0,9
893,15226,17583,744,838,14388,247755,75603,0,9
894,15134,13488,746,712,14422,249401,75569,0,9
895,15136,18877,714,878,14258,245660,75733,0,9
896,14995,15479,737,794,14201,245176,75790,0,9
897,14998,14612,797,780,14218,245562,75773,0,9
898,14989,16620,771,763,14226,243931,75765,0,9
899,14930,13675,704,683,14247,245186,75744,0,9
900,15035,14018,788,721,14314,246203,75677,0,9
901,15091,13587,777,639,14452,247707,75539,0,9
902,15216,14522,764,735,14481,248401,75510,0,9
903,15236,13590,755,722,14514,250047,75477,0,9
904,15245,15295,731,741,14504,249997,75487,0,9
905,15262,15088,758,728,14534,250171,75457,0,9
906,15285,13719,751,684,14601,251737,75390,0,9
907,15338,16748,737,812,14526,250327,75465,0,9
908,15271,12300,745,614,14657,253298,75334,0,9
909,15412,16110,755,785,14627,252600,75364,0,9
910,15392,17931,765,862,14530,250061,75461,0,9
911,15297,16026,767,779,14518,249332,75473,0,9
912,15271,16568,753,840,14431,248035,75560,0,9
913,15223,15515,792,738,14485,247743,75506,0,9
914,15258,14943,773,738,14520,248058,75471,0,9
915,15263,16658,743,823,14440,246663,75551,0,9
916,15209,14752,769,776,14433,247120,75558,0,9
917,15177,17272,744,836,14341,245025,75650,0,9
918,15130,16039,789,845,14285,244116,75707,0,8
919,15069,16708,784,842,14227,242477,75765,0,8
920,14974,14599,747,734,14240,242852,75752,0,8
921,14987,14034,747,709,14278,243805,75714,0,8
922,15068,11346,790,608,14460,247527,75532,0,8
923,15277,15329,817,784,14493,247475,75499,0,8
924,15298,15192,805,734,14564,247581,75428,0,8
925,15362,12759,798,712,14650,250184,75342,0,8
926,15434,15047,784,755,14679,250571,75313,0,8
927,15458,12066,779,680,14778,253963,75214,0,8
928,15582,15518,804,697,14885,254027,75107,0,8
929,15631,19329,746,929,14702,250329,75290,0,8
930,15497,13292,795,683,14814,252534,75178,0,8
931,15548,12389,734,623,14925,255693,75067,0,8
932,15672,13525,747,703,14969,257840,75023,0,8
933,15698,15148,729,787,14911,258390,75081,0,8
934,15683,14154,772,692,14991,259919,75001,0,8
935,15789,18247,798,872,14917,257461,75075,0,8
936,15674,17686,757,874,14800,255449,75192,0,8
937,15583,15075,783,754,14829,255957,75163,0,8
938,15592,15182,763,769,14823,256367,75169,0,8
939,15607,11427,784,648,14959,260547,75033,0,8
940,15672,13762,713,714,14958,262457,75034,0,8
941,15693,16918,735,790,14903,261232,75090,0,7
942,15673,15431,770,771,14902,261474,75091,0,7
943,15622,13815,720,678,14944,263281,75049,0,7
944,15636,14904,692,742,14894,264013,75099,0,7
945,15639,19186,745,902,14737,260466,75256,0,7
946,15488,19323,751,875,14613,256631,75380,0,7
947,15344,13760,731,691,14653,258215,75340,0,7
948,15422,16576,769,795,14627,257061,75366,0,7
949,15396,17162,769,856,14540,255295,75453,0,7
950,15337,16321,797,796,14541,254311,75452,0,7
951,15316,13953,775,694,14622,255674,75371,0,7
952,15336,15836,714,782,14554,255174,75439,0,7
953,15336,16048,782,803,14533,254462,75460,0,7
954,15239,13453,706,651,14588,256248,75405,0,7
955,15357,16966,769,833,14524,254639,75469,0,7
956,15334,18527,810,857,14477,251446,75516,0,7
957,15248,17710,771,841,14407,248984,75586,0,7
958,15132,17457,725,898,14234,246659,75759,0,7
959,14971,16231,737,707,14264,245399,75729,0,7
960,15020,18317,756,879,14141,242102,75852,0,7
961,14899,11352,758,595,14304,245649,75689,0,7
962,15047,14364,743,711,14336,246332,75657,0,7
963,15066,14572,730,747,14319,246826,75674,0,7
964,15056,16519,737,820,14236,245363,75757,0,7
965,14936,15105,700,747,14189,245194,75804,0,7
966,14960,15919,771,807,14153,244235,75840,0,7
967,14916,15531,763,781,14135,243620,75858,0,7
968,14862,14628,727,680,14182,243854,75811,0,7
969,14943,15065,761,763,14180,243732,75813,0,7
970,14944,13938,764,693,14251,244738,75742,0,7
971,14948,17180,697,845,14103,242506,75890,0,7
972,14818,13796,715,691,14127,243528,75866,0,7
973,14875,9651,748,486,14389,248752,75604,0,7
974,15160,15266,771,753,14407,248646,75586,0,7
975,15142,18884,735,895,14247,244904,75746,0,7
976,15026,17637,779,878,14148,242293,75846,0,6
977,14903,12663,755,678,14225,244533,75769,0,6
978,15025,11544,800,612,14413,248014,75581,0,6
979,15181,15374,768,764,14417,247821,75577,0,6
980,15113,15861,696,797,14316,247073,75678,0,6
981,15054,12269,738,576,14478,249858,75516,0,6
982,15204,12228,726,646,14558,252834,75436,0,6
983,15293,14455,735,685,14608,253672,75386,0,6
984,15341,15575,733,737,14604,253438,75390,0,6
985,15341,12960,737,592,14749,255819,75245,0,6
986,15500,15386,751,721,14779,255933,75215,0,6
987,15546,13382,767,719,14827,258097,75167,0,6
988,15581,17761,754,885,14696,255917,75298,0,6
989,15496,12602,800,645,14851,258811,75143,0,6
990,15652,20424,801,964,14688,254039,75306,0,6
991,15447,14806,759,740,14707,254680,75287,0,6
992,15426,16997,719,839,14587,253109,75407,0,6
993,15358,16191,771,760,14598,252276,75396,0,6
994,15366,14792,768,757,14609,252850,75385,0,6
995,15364,14980,755,744,14620,253234,75374,0,6
996,15385,15752,765,752,14633,252867,75361,0,6
997,15374,13138,741,659,14715,255103,75279,0,6
998,15451,15710,736,786,14665,254844,75329,0,6
999,15418,17569,753,830,14588,252693,75406,0,6
1000,15343,14303,755,683,14660,253733,75334,0,6
1001,15392,12657,732,651,14741,256468,75253,0,6
1002,15467,17180,726,811,14656,254755,75338,0,6
1003,15348,17723,692,858,14490,252380,75505,0,5
1004,15212,11390,722,575,14637,256202,75358,0,5
1005,15356,16809,719,804,14552,254749,75443,0,5
1006,15309,15900,757,768,14541,254158,75454,0,5
1007,15267,16380,726,835,14432,253045,75563,0,5
1008,15193,17227,761,862,14331,251011,75664,0,5
1009,15040,17549,709,796,14244,248502,75751,0,5
1010,15071,16294,827,795,14276,247279,75720,0,4
1011,15026,14281,750,704,14322,248024,75674,0,4
1012,15078,20640,756,939,14139,242462,75858,0,3
1013,14904,11573,765,583,14321,245793,75676,0,3
1014,15073,16813,752,816,14257,244053,75740,0,3
1015,15023,12198,766,678,14345,246878,75652,0,3
1016,15100,13511,755,686,14414,248467,75583,0,3
1017,15100,12724,686,662,14438,250843,75559,0,3
1018,15197,15650,759,753,14444,250390,75553,0,3
1019,15239,15415,795,749,14490,250214,75507,0,3
1020,15228,15532,738,749,14479,249910,75518,0,3
1021,15172,16104,693,788,14384,248978,75613,0,3
1022,15128,12872,744,621,14507,251234,75490,0,3
1023,15265,17504,758,874,14391,248995,75606,0,3
1024,15145,16306,754,801,14344,247834,75653,0,3
1025,15124,15768,780,725,14399,247190,75598,0,3
1026,15186,16484,787,797,14389,245892,75608,0,3
1027,15179,13097,790,663,14516,247974,75481,0,3
1028,15300,14668,784,764,14536,248606,75461,0,3
1029,15302,14942,766,782,14520,248966,75477,0,3
1030,15227,11934,707,679,14548,252259,75449,0,3
1031,15329,14246,781,698,14631,253342,75366,0,3
1032,15340,16700,709,776,14564,251982,75433,0,3
1033,15291,16637,727,827,14464,250636,75533,0,3
1034,15194,10435,730,535,14659,255395,75338,0,3
1035,15365,13283,706,706,14659,257477,75338,0,3
1036,15439,19242,780,915,14524,253674,75473,0,3
1037,15279,15904,755,773,14506,253049,75491,0,3
1038,15228,16967,722,770,14458,251310,75539,0,3
1039,15183,17849,725,860,14323,248644,75674,0,3
1040,15070,16679,747,762,14308,247035,75689,0,3
1041,15080,14283,772,713,14367,247832,75630,0,3
1042,15127,15899,760,821,14306,247060,75691,0,3
1043,15043,15616,737,793,14250,246487,75747,0,3
1044,14999,17901,749,873,14126,243585,75871,0,3
1045,14916,16906,790,802,14114,241595,75883,0,3
1046,14865,13708,751,685,14180,242752,75817,0,3
1047,14958,10704,778,580,14378,247006,75619,0,3
1048,15144,13322,766,672,14472,248828,75525,0,3
1049,15273,16151,801,841,14432,247950,75565,0,3
1050,15205,10928,773,576,14629,252227,75368,0,3
1051,15374,13796,745,692,14682,253805,75315,0,3
1052,15423,17546,741,895,14528,251682,75469,0,3
1053,15263,10279,735,559,14704,256666,75293,0,3
1054,15463,14327,759,734,14729,257802,75269,0,2
1055,15476,16854,747,795,14681,256424,75317,0,2
1056,15405,15508,724,733,14672,256321,75326,0,2
1057,15414,15416,742,705,14709,256319,75289,0,2
1058,15458,15834,749,735,14723,255943,75275,0,2
1059,15414,13872,691,669,14745,257485,75253,0,2
1060,15489,18877,744,897,14592,254097,75406,0,2
1061,15365,15674,773,759,14606,253788,75392,0,2
1062,15392,17724,786,867,14525,251456,75473,0,2
1063,15280,18104,755,838,14442,248632,75556,0,2
1064,15241,14521,799,760,14481,249352,75517,0,2
1065,15227,21207,746,1008,14219,243372,75779,0,2
1066,14901,12106,682,636,14265,246167,75733,0,2
1067,15036,15767,771,793,14243,245436,75755,0,2
1068,14978,17987,735,876,14102,242427,75896,0,2
1069,14838,11737,736,642,14196,245528,75802,0,2
1070,14937,15413,741,748,14189,245052,75809,0,2
1071,14945,16063,756,774,14171,243934,75827,0,2
1072,14952,12516,781,638,14314,246370,75684,0,2
1073,15053,11608,739,629,14424,249815,75574,0,2
1074,15201,13413,777,667,14534,251603,75464,0,2
1075,15258,12324,724,626,14632,254537,75367,0,1
1076,15391,18864,759,908,14483,251064,75517,0,0
1077,15196,12830,713,661,14535,253430,75465,0,0
1078,15351,13933,816,681,14670,254848,75330,0,0
1079,15412,18449,742,890,14522,251811,75478,0,0
1080,15291,13457,769,737,14554,253645,75446,0,0
1081,15297,16450,743,801,14496,252492,75504,0,0
1082,15250,14130,754,746,14504,253612,75496,0,0
1083,15282,13504,778,707,14575,255390,75425,0,0
1084,15312,16368,737,805,14507,254334,75493,0,0
1085,15264,12052,757,608,14656,257546,75344,0,0
1086,15433,16817,777,812,14621,256162,75379,0,0
1087,15373,12999,752,642,14731,258536,75269,0,0
1088,15501,19058,770,935,14566,254979,75434,0,0
1089,15299,16258,733,844,14455,254020,75545,0,0
1090,15236,17855,781,779,14457,251401,75543,0,0
1091,15188,18024,731,864,14324,248565,75676,0,0
1092,15110,18390,786,898,14212,245285,75788,0,0
1093,14984,12782,772,690,14294,247487,75706,0,0
1094,15000,14955,706,718,14282,247532,75718,0,0
1095,15063,14768,781,743,14320,247827,75680,0,0
1096,15056,13321,736,692,14364,249562,75636,0,0
1097,15120,14629,756,743,14377,250053,75623,0,0
1098,15142,11911,765,578,14564,253284,75436,0,0
1099,15316,15472,752,746,14570,253128,75430,0,0
1100,15314,14008,744,704,14610,254434,75390,0,0
