Step,mass_grown,mass_burnt,trees_grown,trees_burnt,trees_count,trees_mass,ashes_count,ashes_mass,empty_count
100,24673,0,73,0,24673,2203386,200,0,65127
101,24737,0,64,0,24737,2228123,199,0,65064
102,24791,0,54,0,24791,2252914,199,0,65010
103,24851,0,60,0,24851,2277765,198,0,64951
104,24936,0,85,0,24936,2302701,198,0,64866
105,24991,426,55,4,24987,2327266,202,0,64811
106,25051,0,64,0,25051,2352317,201,0,64748
107,25106,0,55,0,25106,2377423,201,0,64693
108,25162,0,56,0,25162,2402585,201,0,64637
109,25210,0,48,0,25210,2427795,201,0,64589
110,25293,0,83,0,25293,2453088,200,0,64507
111,25365,0,72,0,25365,2478453,199,0,64436
112,25446,7775,81,76,25370,2496124,275,0,64355
113,25429,0,59,0,25429,2521553,274,0,64297
114,25473,727,44,7,25466,2546299,281,0,64253
115,25542,402,76,4,25538,2571439,285,0,64177
116,25614,0,76,0,25614,2597053,285,0,64101
117,25681,864,67,8,25673,2621870,293,0,64034
118,25745,0,72,0,25745,2647615,293,0,63962
119,25826,0,81,0,25826,2673441,291,0,63883
120,25882,0,56,0,25882,2699323,291,0,63827
121,25955,144,73,2,25953,2725134,293,0,63754
122,26012,1447,59,14,25998,2749699,307,0,63695
123,26064,0,66,0,26064,2775763,305,0,63631
124,26122,0,58,0,26122,2801885,305,0,63573
125,26178,0,56,0,26178,2828063,305,0,63517
126,26236,0,58,0,26236,2854299,305,0,63459
127,26310,0,74,0,26310,2880609,304,0,63386
128,26386,0,76,0,26386,2906995,304,0,63310
129,26450,7667,64,66,26384,2925778,370,0,63246
130,26437,0,53,0,26437,2952215,370,0,63193
131,26490,2981,53,27,26463,2975724,397,0,63140
132,26525,0,62,0,26525,3002249,397,0,63078
133,26585,9266,60,82,26503,3019568,479,0,63018
134,26574,399,71,3,26571,3045743,482,0,62947
135,26638,0,67,0,26638,3072381,482,0,62880
136,26706,0,68,0,26706,3099087,482,0,62812
137,26774,1425,68,11,26763,3124436,493,0,62744
138,26823,0,60,0,26823,3151259,492,0,62685
139,26889,0,66,0,26889,3178148,492,0,62619
140,26958,0,69,0,26958,3205106,492,0,62550
141,27016,0,58,0,27016,3232122,492,0,62492
142,27064,0,48,0,27064,3259186,491,0,62445
143,27135,0,71,0,27135,3286321,490,0,62375
144,27210,148,75,1,27209,3313383,491,0,62300
145,27275,7148,66,61,27214,3333510,552,0,62234
146,27263,0,49,0,27263,3360773,551,0,62186
147,27338,0,75,0,27338,3388111,550,0,62112
148,27398,0,60,0,27398,3415509,550,0,62052
149,27469,2745,71,21,27448,3440233,570,0,61982
150,27520,345,72,4,27516,3467408,573,0,61911
151,27569,6596,53,51,27518,3488381,623,0,61859
152,27579,0,61,0,27579,3515960,622,0,61799
153,27648,7553,69,56,27592,3536055,678,0,61730
154,27652,0,60,0,27652,3563707,677,0,61671
155,27707,7047,55,59,27648,3584367,736,0,61616
156,27712,0,64,0,27712,3612079,735,0,61553
157,27764,0,52,0,27764,3639843,735,0,61501
158,27834,31579,70,243,27591,3636098,978,0,61431
159,27658,8870,67,71,27587,3654886,1047,0,61366
160,27649,0,62,0,27649,3682535,1045,0,61306
161,27703,6189,54,49,27654,3704049,1093,0,61253
162,27715,0,61,0,27715,3731764,1091,0,61194
163,27782,0,67,0,27782,3759546,1089,0,61129
164,27853,0,71,0,27853,3787399,1087,0,61060
165,27917,0,64,0,27917,3815316,1087,0,60996
166,27981,0,64,0,27981,3843297,1083,0,60936
167,28052,8964,71,62,27990,3862385,1142,0,60868
168,28054,2566,64,16,28038,3887873,1158,0,60804
169,28093,0,55,0,28093,3915966,1157,0,60750
170,28161,0,68,0,28161,3944127,1154,0,60685
171,28219,0,58,0,28219,3972346,1154,0,60627
172,28279,0,60,0,28279,4000625,1154,0,60567
173,28337,8140,58,54,28283,4020822,1208,0,60509
174,28342,0,59,0,28342,4049164,1208,0,60450
175,28402,0,60,0,28402,4077566,1208,0,60390
176,28464,18294,62,128,28336,4087736,1334,0,60330
177,28389,0,53,0,28389,4116125,1334,0,60277
178,28455,0,66,0,28455,4144580,1331,0,60214
179,28508,0,53,0,28508,4173088,1330,0,60162
180,28565,15319,57,104,28461,4186334,1432,0,60107
181,28511,0,50,0,28511,4214845,1430,0,60059
182,28578,0,67,0,28578,4243423,1428,0,59994
183,28635,378,57,2,28633,4271680,1429,0,59938
184,28695,0,62,0,28695,4300375,1428,0,59877
185,28746,0,51,0,28746,4329121,1423,0,59831
186,28806,0,60,0,28806,4357927,1423,0,59771
187,28866,0,60,0,28866,4386793,1423,0,59711
188,28921,0,55,0,28921,4415714,1422,0,59657
189,28981,0,60,0,28981,4444695,1422,0,59597
190,29035,0,54,0,29035,4473730,1421,0,59544
191,29095,26515,60,178,28917,4476310,1598,0,59485
192,28968,0,51,0,28968,4505278,1597,0,59435
193,29016,41349,48,250,28766,4492945,1845,0,59389
194,28842,0,76,0,28842,4521787,1843,0,59315
195,28896,0,54,0,28896,4550683,1843,0,59261
196,28952,0,56,0,28952,4579635,1841,0,59207
197,29016,0,64,0,29016,4608651,1840,0,59144
198,29071,0,55,0,29071,4637722,1840,0,59089
199,29142,0,71,0,29142,4666864,1837,0,59021
200,29201,0,59,0,29201,4696065,1836,0,58963
201,29266,31780,65,193,29073,4693551,2024,0,58903
202,29136,25919,63,169,28967,4696768,2190,0,58843
203,29024,2210,57,14,29010,4723582,2204,0,58786
204,29068,27440,58,169,28899,4725210,2373,0,58728
205,28965,1206,66,8,28957,4752969,2379,0,58664
206,29009,0,52,0,29009,4781978,2376,0,58615
207,29071,633,62,3,29068,4810416,2378,0,58554
208,29127,0,59,0,29127,4839543,2373,0,58500
209,29187,0,60,0,29187,4868730,2370,0,58443
210,29258,3350,71,19,29239,4894638,2383,0,58378
211,29301,0,62,0,29301,4923939,2380,0,58319
212,29344,0,43,0,29344,4953283,2377,0,58279
213,29399,2803,55,14,29385,4979879,2391,0,58224
214,29432,0,47,0,29432,5009311,2391,0,58177
215,29471,0,39,0,29471,5038782,2389,0,58140
216,29538,0,67,0,29538,5068320,2388,0,58074
217,29589,0,51,0,29589,5097909,2385,0,58026
218,29653,0,64,0,29653,5127562,2384,0,57963
219,29714,0,61,0,29714,5157276,2384,0,57902
220,29773,0,59,0,29773,5187049,2382,0,57845
221,29835,123448,62,685,29150,5093436,3063,0,57787
222,29206,0,56,0,29206,5122642,3061,0,57733
223,29259,47914,53,257,29002,5103987,3316,0,57682
224,29067,0,65,0,29067,5133054,3313,0,57620
225,29124,0,57,0,29124,5162178,3308,0,57568
226,29187,40425,63,229,28958,5150940,3533,0,57509
227,29029,6243,71,39,28990,5173726,3567,0,57443
228,29046,127,56,2,29044,5202645,3565,0,57391
229,29089,27804,45,153,28936,5203930,3716,0,57348
230,28996,0,60,0,28996,5232926,3711,0,57293
231,29061,28555,65,146,28915,5233432,3853,0,57232
232,28981,0,66,0,28981,5262413,3850,0,57169
233,29040,0,59,0,29040,5291453,3848,0,57112
234,29106,0,66,0,29106,5320559,3843,0,57051
235,29177,0,71,0,29177,5349736,3836,0,56987
236,29240,0,63,0,29240,5378976,3831,0,56929
237,29301,13294,61,69,29232,5394983,3893,0,56875
238,29287,34268,55,175,29112,5390002,4066,0,56822
239,29172,8171,60,44,29128,5411003,4109,0,56763
240,29192,0,64,0,29192,5440195,4108,0,56700
241,29254,0,62,0,29254,5469449,4102,0,56644
242,29324,7802,70,41,29283,5490971,4133,0,56584
243,29350,0,67,0,29350,5520321,4131,0,56519
244,29390,12535,40,65,29325,5537176,4193,0,56482
245,29375,0,50,0,29375,5566551,4186,0,56439
246,29446,0,71,0,29446,5595997,4182,0,56372
247,29521,0,75,0,29521,5625518,4176,0,56303
248,29572,0,51,0,29572,5655090,4171,0,56257
249,29627,0,55,0,29627,5684717,4165,0,56208
250,29690,13823,63,71,29619,5700584,4232,0,56149
251,29681,14940,62,77,29604,5715325,4303,0,56093
252,29665,0,61,0,29665,5744990,4297,0,56038
253,29731,0,66,0,29731,5774721,4291,0,55978
254,29785,0,54,0,29785,5804506,4287,0,55928
255,29840,203679,55,1004,28836,5630667,5287,0,55877
256,28907,10500,71,54,28853,5649074,5335,0,55812
257,28915,0,62,0,28915,5677989,5331,0,55754
258,28975,39224,60,190,28785,5667740,5514,0,55701
259,28832,17655,47,88,28744,5678917,5599,0,55657
260,28824,10294,80,54,28770,5697447,5649,0,55581
261,28821,172423,51,833,27988,5553845,6477,0,55535
262,28060,20555,72,102,27958,5561350,6569,0,55473
263,28007,0,49,0,28007,5589357,6564,0,55429
264,28071,0,64,0,28071,5617428,6558,0,55371
265,28133,0,62,0,28133,5645561,6550,0,55317
266,28200,0,67,0,28200,5673761,6542,0,55258
267,28263,0,63,0,28263,5702024,6538,0,55199
268,28311,0,48,0,28311,5730335,6531,0,55158
269,28369,0,58,0,28369,5758704,6525,0,55106
270,28434,7844,65,37,28397,5779294,6555,0,55048
271,28452,4917,55,27,28425,5802829,6577,0,54998
272,28490,0,65,0,28490,5831319,6573,0,54937
273,28540,0,50,0,28540,5859859,6564,0,54896
274,28606,22248,66,102,28504,5866217,6662,0,54834
275,28562,0,58,0,28562,5894779,6657,0,54781
276,28623,198236,61,908,27715,5725166,7560,0,54725
277,27791,0,76,0,27791,5752957,7553,0,54656
278,27854,155502,63,719,27135,5625309,8262,0,54603
279,27195,6992,60,35,27160,5645512,8287,0,54553
280,27235,0,75,0,27235,5672747,8270,0,54495
281,27288,0,53,0,27288,5700035,8261,0,54451
282,27352,16930,64,77,27275,5710457,8327,0,54398
283,27344,0,69,0,27344,5737801,8316,0,54340
284,27400,522,56,2,27398,5764679,8310,0,54292
285,27460,0,62,0,27460,5792139,8301,0,54239
286,27535,51211,75,226,27309,5768463,8517,0,54174
287,27370,0,61,0,27370,5795833,8508,0,54122
288,27435,0,65,0,27435,5823268,8503,0,54062
289,27497,0,62,0,27497,5850765,8497,0,54006
290,27550,0,53,0,27550,5878315,8488,0,53962
291,27617,0,67,0,27617,5905932,8477,0,53906
292,27680,0,63,0,27680,5933612,8473,0,53847
293,27744,0,64,0,27744,5961356,8471,0,53785
294,27819,0,75,0,27819,5989175,8460,0,53721
295,27886,0,67,0,27886,6017061,8453,0,53661
296,27948,0,62,0,27948,6045009,8445,0,53607
297,28028,12008,80,47,27981,6061029,8485,0,53534
298,28051,0,70,0,28051,6089080,8475,0,53474
299,28117,16918,66,79,28038,6100279,8549,0,53413
300,28108,0,70,0,28108,6128387,8538,0,53354
301,28157,0,49,0,28157,6156544,8529,0,53314
302,28215,0,58,0,28215,6184759,8520,0,53265
303,28277,0,62,0,28277,6213036,8516,0,53207
304,28337,222862,60,977,27360,6018511,9482,0,53158
305,27428,0,68,0,27428,6045939,9474,0,53098
306,27484,0,56,0,27484,6073423,9466,0,53050
307,27546,0,62,0,27546,6100969,9464,0,52990
308,27613,0,67,0,27613,6128582,9450,0,52937
309,27680,0,67,0,27680,6156262,9432,0,52888
310,27737,0,57,0,27737,6183999,9421,0,52842
311,27796,237669,59,1038,26758,5974126,10449,0,52793
312,26815,14495,57,61,26754,5986446,10499,0,52747
313,26829,0,75,0,26829,6013275,10489,0,52682
314,26889,0,60,0,26889,6040164,10479,0,52632
315,26947,0,58,0,26947,6067111,10468,0,52585
316,27018,0,71,0,27018,6094129,10458,0,52524
317,27078,0,60,0,27078,6121207,10447,0,52475
318,27156,0,78,0,27156,6148363,10429,0,52415
319,27202,0,46,0,27202,6175565,10423,0,52375
320,27263,0,61,0,27263,6202828,10415,0,52322
321,27332,0,69,0,27332,6230160,10403,0,52265
322,27380,0,48,0,27380,6257540,10393,0,52227
323,27452,0,72,0,27452,6284992,10378,0,52170
324,27522,0,70,0,27522,6312514,10366,0,52112
325,27584,0,62,0,27584,6340098,10353,0,52063
326,27654,0,70,0,27654,6367752,10343,0,52003
327,27721,0,67,0,27721,6395473,10333,0,51946
328,27783,2073,62,9,27774,6421183,10329,0,51897
329,27822,0,48,0,27822,6449005,10322,0,51856
330,27896,0,74,0,27896,6476901,10309,0,51795
331,27963,553905,67,2237,25726,5950959,12535,0,51739
332,25791,0,65,0,25791,5976750,12521,0,51688
333,25851,0,60,0,25851,6002601,12510,0,51639
334,25912,0,61,0,25912,6028513,12495,0,51593
335,25976,38885,64,146,25830,6015604,12629,0,51541
336,25895,0,65,0,25895,6041499,12616,0,51489
337,25953,233,58,5,25948,6067219,12604,0,51448
338,26028,0,80,0,26028,6093247,12588,0,51384
339,26095,0,67,0,26095,6119342,12573,0,51332
340,26149,0,54,0,26149,6145491,12566,0,51285
341,26209,0,60,0,26209,6171700,12552,0,51239
342,26274,0,65,0,26274,6197974,12537,0,51189
343,26337,0,63,0,26337,6224311,12525,0,51138
344,26404,0,67,0,26404,6250715,12514,0,51082
345,26473,0,69,0,26473,6277188,12497,0,51030
346,26535,0,62,0,26535,6303723,12489,0,50976
347,26602,0,67,0,26602,6330325,12476,0,50922
348,26668,0,66,0,26668,6356993,12459,0,50873
349,26737,0,69,0,26737,6383730,12448,0,50815
350,26811,0,74,0,26811,6410541,12430,0,50759
351,26871,0,60,0,26871,6437412,12417,0,50712
352,26922,0,51,0,26922,6464334,12407,0,50671
353,26983,0,61,0,26983,6491317,12393,0,50624
354,27055,582529,72,2268,24787,5935843,14646,0,50567
355,24849,0,62,0,24849,5960692,14635,0,50516
356,24925,0,76,0,24925,5985617,14618,0,50457
357,25002,0,77,0,25002,6010619,14599,0,50399
358,25061,0,59,0,25061,6035680,14583,0,50356
359,25129,0,68,0,25129,6060809,14569,0,50302
360,25196,0,67,0,25196,6086005,14548,0,50256
361,25259,0,63,0,25259,6111264,14530,0,50211
362,25329,0,70,0,25329,6136593,14516,0,50155
363,25377,0,48,0,25377,6161970,14505,0,50118
364,25453,0,76,0,25453,6187423,14489,0,50058
365,25525,0,72,0,25525,6212948,14473,0,50002
366,25596,0,71,0,25596,6238544,14458,0,49946
367,25669,0,73,0,25669,6264213,14442,0,49889
368,25727,0,58,0,25727,6289940,14427,0,49846
369,25790,0,63,0,25790,6315730,14413,0,49797
370,25861,0,71,0,25861,6341591,14399,0,49740
371,25924,0,63,0,25924,6367515,14380,0,49696
372,25991,0,67,0,25991,6393506,14374,0,49635
373,26052,0,61,0,26052,6419558,14356,0,49592
374,26129,0,77,0,26129,6445687,14343,0,49528
375,26200,0,71,0,26200,6471887,14331,0,49469
376,26279,0,79,0,26279,6498166,14312,0,49409
377,26328,0,49,0,26328,6524494,14305,0,49367
378,26395,0,67,0,26395,6550889,14290,0,49315
379,26462,0,67,0,26462,6577351,14273,0,49265
380,26531,0,69,0,26531,6603882,14252,0,49217
381,26603,0,72,0,26603,6630485,14236,0,49161
382,26652,0,49,0,26652,6657137,14221,0,49127
383,26715,0,63,0,26715,6683852,14203,0,49082
384,26779,0,64,0,26779,6710631,14187,0,49034
385,26854,0,75,0,26854,6737485,14169,0,48977
386,26929,0,75,0,26929,6764414,14149,0,48922
387,26995,0,66,0,26995,6791409,14131,0,48874
388,27055,5,60,1,27054,6818459,14123,0,48823
389,27109,0,55,0,27109,6845568,14112,0,48779
390,27176,0,67,0,27176,6872744,14103,0,48721
391,27236,0,60,0,27236,6899980,14086,0,48678
392,27289,0,53,0,27289,6927269,14078,0,48633
393,27347,0,58,0,27347,6954616,14073,0,48580
394,27408,0,61,0,27408,6982024,14057,0,48535
395,27467,0,59,0,27467,7009491,14048,0,48485
396,27528,0,61,0,27528,7037019,14034,0,48438
397,27595,0,67,0,27595,7064614,14022,0,48383
398,27657,0,62,0,27657,7092271,14008,0,48335
399,27712,206729,55,715,26997,6913254,14709,0,48294
400,27065,69289,68,253,26812,6871030,14947,0,48241
401,26872,0,60,0,26872,6897902,14932,0,48196
402,26950,0,78,0,26950,6924852,14914,0,48136
403,27016,0,66,0,27016,6951868,14899,0,48085
404,27067,0,51,0,27067,6978935,14884,0,48049
405,27131,3881958,64,13336,13795,3124108,28209,0,47996
406,13865,0,70,0,13865,3137973,28194,0,47941
407,13933,0,68,0,13933,3151906,28175,0,47892
408,14001,0,68,0,14001,3165907,28156,0,47843
409,14081,0,80,0,14081,3179988,28130,0,47789
410,14153,0,72,0,14153,3194141,28100,0,47747
411,14237,0,84,0,14237,3208378,28063,0,47700
412,14314,0,77,0,14314,3222692,28035,0,47651
413,14380,0,66,0,14380,3237072,28014,0,47606
414,14475,0,95,0,14475,3251547,27977,0,47548
415,14540,0,65,0,14540,3266087,27950,0,47510
416,14627,0,87,0,14627,3280714,27917,0,47456
417,14704,0,77,0,14704,3295418,27885,0,47411
418,14775,0,71,0,14775,3310193,27850,0,47375
419,14859,0,84,0,14859,3325052,27815,0,47326
420,14933,0,74,0,14933,3339985,27782,0,47285
421,15021,0,88,0,15021,3355006,27751,0,47228
422,15088,0,67,0,15088,3370094,27730,0,47182
423,15159,0,71,0,15159,3385253,27700,0,47141
424,15219,0,60,0,15219,3400472,27683,0,47098
425,15293,0,74,0,15293,3415765,27657,0,47050
426,15364,0,71,0,15364,3431129,27634,0,47002
427,15430,0,66,0,15430,3446559,27613,0,46957
428,15515,0,85,0,15515,3462074,27583,0,46902
429,15588,0,73,0,15588,3477662,27560,0,46852
430,15660,0,72,0,15660,3493322,27544,0,46796
431,15722,28,62,1,15721,3509016,27515,0,46764
432,15809,0,88,0,15809,3524825,27476,0,46715
433,15890,0,81,0,15890,3540715,27437,0,46673
434,15963,0,73,0,15963,3556678,27413,0,46624
435,16034,0,71,0,16034,3572712,27384,0,46582
436,16096,0,62,0,16096,3588808,27361,0,46543
437,16155,0,59,0,16155,3604963,27339,0,46506
438,16251,18508,96,66,16185,3602706,27370,0,46445
439,16258,25354,73,83,16175,3593610,27429,0,46396
440,16252,0,77,0,16252,3609862,27395,0,46353
441,16338,0,86,0,16338,3626200,27357,0,46305
442,16415,2,77,1,16414,3642613,27328,0,46258
443,16507,0,93,0,16507,3659120,27285,0,46208
444,16564,0,57,0,16564,3675684,27261,0,46175
445,16629,0,65,0,16629,3692313,27241,0,46130
446,16704,0,75,0,16704,3709017,27212,0,46084
447,16771,0,67,0,16771,3725788,27184,0,46045
448,16841,0,70,0,16841,3742629,27162,0,45997
449,16915,0,74,0,16915,3759544,27141,0,45944
450,16988,0,73,0,16988,3776532,27111,0,45901
451,17064,0,76,0,17064,3793596,27080,0,45856
452,17144,0,80,0,17144,3810740,27051,0,45805
453,17214,0,70,0,17214,3827954,27022,0,45764
454,17300,0,86,0,17300,3845254,26987,0,45713
455,17372,0,72,0,17372,3862626,26961,0,45667
456,17443,0,71,0,17443,3880069,26936,0,45621
457,17506,0,63,0,17506,3897575,26911,0,45583
458,17578,436,72,5,17573,3914717,26889,0,45538
459,17636,0,63,0,17636,3932353,26862,0,45502
460,17697,0,61,0,17697,3950050,26833,0,45470
461,17755,0,58,0,17755,3967805,26807,0,45438
462,17830,0,75,0,17830,3985635,26781,0,45389
463,17895,0,65,0,17895,4003530,26754,0,45351
464,17963,0,68,0,17963,4021493,26733,0,45304
465,18034,0,71,0,18034,4039527,26711,0,45255
466,18117,277,83,2,18115,4057367,26675,0,45210
467,18180,0,65,0,18180,4075547,26650,0,45170
468,18249,0,69,0,18249,4093796,26629,0,45122
469,18335,0,86,0,18335,4112131,26599,0,45066
470,18391,0,56,0,18391,4130522,26575,0,45034
471,18460,0,69,0,18460,4148982,26552,0,44988
472,18532,0,72,0,18532,4167514,26517,0,44951
473,18603,0,71,0,18603,4186117,26490,0,44907
474,18665,0,62,0,18665,4204782,26465,0,44870
475,18736,0,71,0,18736,4223518,26442,0,44822
476,18798,0,62,0,18798,4242316,26418,0,44784
477,18855,0,57,0,18855,4261171,26391,0,44754
478,18927,0,72,0,18927,4280098,26366,0,44707
479,18991,0,64,0,18991,4299089,26341,0,44668
480,19068,0,77,0,19068,4318157,26310,0,44622
481,19131,0,63,0,19131,4337288,26289,0,44580
482,19198,0,67,0,19198,4356486,26264,0,44538
483,19265,0,67,0,19265,4375751,26244,0,44491
484,19340,0,75,0,19340,4395091,26219,0,44441
485,19396,0,56,0,19396,4414487,26202,0,44402
486,19458,0,62,0,19458,4433945,26178,0,44364
487,19543,590364,85,1760,17783,3863124,27897,0,44320
488,17856,0,73,0,17856,3880980,27870,0,44274
489,17947,0,91,0,17947,3898927,27832,0,44221
490,18025,0,78,0,18025,3916952,27807,0,44168
491,18099,0,74,0,18099,3935051,27774,0,44127
492,18175,0,76,0,18175,3953226,27746,0,44079
493,18251,0,76,0,18251,3971477,27717,0,44032
494,18316,0,65,0,18316,3989793,27690,0,43994
495,18380,58110,64,171,18209,3950063,27833,0,43958
496,18284,0,75,0,18284,3968347,27806,0,43910
497,18347,0,63,0,18347,3986694,27783,0,43870
498,18408,108263,61,351,18057,3896839,28105,0,43838
499,18125,0,68,0,18125,3914964,28082,0,43793
500,18197,0,72,0,18197,3933161,28050,0,43753
501,18259,0,62,0,18259,3951420,28029,0,43712
502,18342,0,83,0,18342,3969762,27994,0,43664
503,18410,0,68,0,18410,3988172,27968,0,43622
504,18487,0,77,0,18487,4006659,27940,0,43573
505,18554,818842,67,2342,16212,3206371,30259,0,43529
506,16295,1427,83,15,16280,3221239,30234,0,43486
507,16360,0,80,0,16360,3237599,30199,0,43441
508,16439,0,79,0,16439,3254038,30167,0,43394
509,16499,0,60,0,16499,3270537,30139,0,43362
510,16566,0,67,0,16566,3287103,30114,0,43320
511,16634,0,68,0,16634,3303737,30088,0,43278
512,16705,0,71,0,16705,3320442,30067,0,43228
513,16787,0,82,0,16787,3337229,30031,0,43182
514,16876,0,89,0,16876,3354105,30000,0,43124
515,16963,0,87,0,16963,3371068,29965,0,43072
516,17044,0,81,0,17044,3388112,29932,0,43024
517,17116,0,72,0,17116,3405228,29900,0,42984
518,17203,0,87,0,17203,3422431,29862,0,42935
519,17263,69143,60,197,17066,3370551,30040,0,42894
520,17143,867,77,7,17136,3386827,30020,0,42844
521,17216,0,80,0,17216,3404043,29989,0,42795
522,17298,0,82,0,17298,3421341,29957,0,42745
523,17372,0,74,0,17372,3438713,29925,0,42703
524,17454,0,82,0,17454,3456167,29894,0,42652
525,17518,0,64,0,17518,3473685,29876,0,42606
526,17605,0,87,0,17605,3491290,29845,0,42550
527,17675,0,70,0,17675,3508965,29813,0,42512
528,17742,16,67,1,17741,3526691,29788,0,42471
529,17811,0,70,0,17811,3544502,29760,0,42429
530,17895,0,84,0,17895,3562397,29725,0,42380
531,17975,0,80,0,17975,3580372,29698,0,42327
532,18037,0,62,0,18037,3598409,29675,0,42288
533,18101,1295,64,5,18096,3615215,29656,0,42248
534,18168,0,72,0,18168,3633383,29626,0,42206
535,18240,3058,72,9,18231,3648565,29603,0,42166
536,18289,0,58,0,18289,3666854,29583,0,42128
537,18355,0,66,0,18355,3685209,29554,0,42091
538,18421,295,66,3,18418,3703335,29529,0,42053
539,18494,0,76,0,18494,3721829,29507,0,41999
540,18563,0,69,0,18563,3740392,29475,0,41962
541,18637,0,74,0,18637,3759029,29444,0,41919
542,18704,0,67,0,18704,3777733,29413,0,41883
543,18770,0,66,0,18770,3796503,29381,0,41849
544,18856,298,86,2,18854,3815061,29361,0,41785
545,18924,0,70,0,18924,3833985,29325,0,41751
546,18994,0,70,0,18994,3852979,29294,0,41712
547,19065,0,71,0,19065,3872044,29265,0,41670
548,19126,0,61,0,19126,3891170,29244,0,41630
549,19193,0,67,0,19193,3910363,29208,0,41599
550,19255,0,62,0,19255,3929618,29184,0,41561
551,19332,0,77,0,19332,3948950,29158,0,41510
552,19393,0,61,0,19393,3968343,29129,0,41478
553,19474,0,81,0,19474,3987817,29101,0,41425
554,19541,0,67,0,19541,4007358,29074,0,41385
555,19602,150332,61,385,19217,3876628,29431,0,41352
556,19286,0,69,0,19286,3895914,29405,0,41309
557,19354,0,68,0,19354,3915268,29376,0,41270
558,19432,0,78,0,19432,3934700,29342,0,41226
559,19512,0,80,0,19512,3954212,29307,0,41181
560,19585,0,73,0,19585,3973797,29279,0,41136
561,19646,0,61,0,19646,3993443,29258,0,41096
562,19719,0,73,0,19719,4013162,29233,0,41048
563,19799,0,80,0,19799,4032961,29200,0,41001
564,19881,0,82,0,19881,4052842,29161,0,40958
565,19948,34,67,1,19947,4072756,29140,0,40913
566,20022,0,75,0,20022,4092778,29113,0,40865
567,20086,0,64,0,20086,4112864,29087,0,40827
568,20160,0,74,0,20160,4133024,29050,0,40790
569,20230,0,70,0,20230,4153254,29021,0,40749
570,20309,0,79,0,20309,4173563,28984,0,40707
571,20364,0,55,0,20364,4193927,28963,0,40673
572,20437,0,73,0,20437,4214364,28927,0,40636
573,20515,1959,78,9,20506,4232920,28901,0,40593
574,20555,0,49,0,20555,4253475,28876,0,40569
575,20626,0,71,0,20626,4274101,28850,0,40524
576,20681,631,55,5,20676,4294151,28838,0,40486
577,20741,0,65,0,20741,4314892,28809,0,40450
578,20814,0,73,0,20814,4335706,28778,0,40408
579,20892,0,78,0,20892,4356598,28754,0,40354
580,20957,0,65,0,20957,4377555,28729,0,40314
581,21038,0,81,0,21038,4398593,28699,0,40263
582,21118,304,80,4,21114,4419407,28668,0,40218
583,21196,1158,82,13,21183,4439445,28642,0,40175
584,21247,0,64,0,21247,4460692,28614,0,40139
585,21331,0,84,0,21331,4482023,28580,0,40089
586,21406,0,75,0,21406,4503429,28546,0,40048
587,21484,0,78,0,21484,4524913,28511,0,40005
588,21551,0,67,0,21551,4546464,28492,0,39957
589,21619,56296,68,152,21467,4511787,28620,0,39913
590,21539,0,72,0,21539,4533326,28594,0,39867
591,21611,0,72,0,21611,4554937,28572,0,39817
592,21686,0,75,0,21686,4576623,28539,0,39775
593,21760,0,74,0,21760,4598383,28508,0,39732
594,21817,0,57,0,21817,4620200,28483,0,39700
595,21874,0,57,0,21874,4642074,28458,0,39668
596,21950,44005,76,149,21801,4620019,28582,0,39617
597,21876,0,75,0,21876,4641895,28556,0,39568
598,21936,0,60,0,21936,4663831,28534,0,39530
599,21999,0,63,0,21999,4685830,28511,0,39490
600,22053,0,54,0,22053,4707883,28490,0,39457
601,22133,0,80,0,22133,4730016,28451,0,39416
602,22212,0,79,0,22212,4752228,28422,0,39366
603,22277,0,65,0,22277,4774505,28399,0,39324
604,22344,0,67,0,22344,4796849,28373,0,39283
605,22422,0,78,0,22422,4819271,28341,0,39237
606,22486,0,64,0,22486,4841757,28309,0,39205
607,22549,0,63,0,22549,4864306,28281,0,39170
608,22615,0,66,0,22615,4886921,28245,0,39140
609,22679,0,64,0,22679,4909600,28213,0,39108
610,22757,0,78,0,22757,4932357,28170,0,39073
611,22828,0,71,0,22828,4955185,28133,0,39039
612,22905,4515,77,24,22881,4973575,28124,0,38995
613,22938,0,57,0,22938,4996513,28101,0,38961
614,22983,0,45,0,22983,5019496,28080,0,38937
615,23062,0,79,0,23062,5042558,28052,0,38886
616,23140,0,78,0,23140,5065698,28018,0,38842
617,23199,0,59,0,23199,5088897,27991,0,38810
618,23273,0,74,0,23273,5112170,27966,0,38761
619,23336,4793,63,23,23313,5130713,27968,0,38719
620,23388,0,75,0,23388,5154101,27938,0,38674
621,23471,0,83,0,23471,5177572,27898,0,38631
622,23541,0,70,0,23541,5201113,27872,0,38587
623,23606,0,65,0,23606,5224719,27839,0,38555
624,23664,0,58,0,23664,5248383,27818,0,38518
625,23741,0,77,0,23741,5272124,27793,0,38466
626,23818,0,77,0,23818,5295942,27756,0,38426
627,23878,0,60,0,23878,5319820,27735,0,38387
628,23953,1329,75,8,23945,5342444,27714,0,38341
629,24013,0,68,0,24013,5366457,27685,0,38302
630,24107,0,94,0,24107,5390564,27650,0,38243
631,24188,0,81,0,24188,5414752,27620,0,38192
632,24239,0,51,0,24239,5438991,27595,0,38166
633,24312,0,73,0,24312,5463303,27561,0,38127
634,24382,0,70,0,24382,5487685,27530,0,38088
635,24453,0,71,0,24453,5512138,27496,0,38051
636,24514,0,61,0,24514,5536652,27472,0,38014
637,24573,208790,59,547,24026,5352435,28001,0,37973
638,24090,0,64,0,24090,5376525,27975,0,37935
639,24149,0,59,0,24149,5400674,27954,0,37897
640,24209,0,60,0,24209,5424883,27923,0,37868
641,24293,0,84,0,24293,5449176,27878,0,37829
642,24364,290,71,3,24361,5473250,27855,0,37784
643,24427,143312,66,411,24016,5354365,28237,0,37747
644,24083,0,67,0,24083,5378448,28208,0,37709
645,24132,0,49,0,24132,5402580,28188,0,37680
646,24203,0,71,0,24203,5426783,28166,0,37631
647,24268,0,65,0,24268,5451051,28135,0,37597
648,24335,0,67,0,24335,5475386,28102,0,37563
649,24387,0,52,0,24387,5499773,28084,0,37529
650,24454,8295,67,45,24409,5515932,28099,0,37492
651,24476,0,67,0,24476,5540408,28073,0,37451
652,24544,0,68,0,24544,5564952,28046,0,37410
653,24606,0,62,0,24606,5589558,28025,0,37369
654,24673,0,67,0,24673,5614231,28003,0,37324
655,24728,0,55,0,24728,5638959,27982,0,37290
656,24787,0,59,0,24787,5663746,27955,0,37258
657,24869,126320,82,366,24503,5562295,28284,0,37213
658,24577,0,74,0,24577,5586872,28248,0,37175
659,24638,80462,61,249,24389,5531048,28469,0,37142
660,24454,0,65,0,24454,5555502,28445,0,37101
661,24519,0,65,0,24519,5580021,28423,0,37058
662,24590,0,71,0,24590,5604611,28390,0,37020
663,24649,0,59,0,24649,5629260,28368,0,36983
664,24708,0,59,0,24708,5653968,28341,0,36951
665,24767,692,59,6,24761,5678043,28318,0,36921
666,24819,0,58,0,24819,5702862,28288,0,36893
667,24899,0,80,0,24899,5727761,28257,0,36844
668,24962,0,63,0,24962,5752723,28228,0,36810
669,25042,0,80,0,25042,5777765,28196,0,36762
670,25096,0,54,0,25096,5802861,28173,0,36731
671,25165,0,69,0,25165,5828026,28152,0,36683
672,25235,0,70,0,25235,5853261,28126,0,36639
673,25304,1924,69,15,25289,5876641,28117,0,36594
674,25354,0,65,0,25354,5901995,28091,0,36555
675,25434,0,80,0,25434,5927429,28057,0,36509
676,25484,0,50,0,25484,5952913,28030,0,36486
677,25546,0,62,0,25546,5978459,27995,0,36459
678,25608,0,62,0,25608,6004067,27974,0,36418
679,25670,0,62,0,25670,6029737,27951,0,36379
680,25723,226,53,3,25720,6055234,27930,0,36350
681,25792,356,72,4,25788,6080670,27902,0,36310
682,25865,0,77,0,25865,6106535,27873,0,36262
683,25936,14577,71,65,25871,6117894,27900,0,36229
684,25925,4279,54,11,25914,6139540,27881,0,36205
685,25988,0,74,0,25988,6165528,27844,0,36168
686,26053,222,65,2,26051,6191359,27816,0,36133
687,26106,0,55,0,26106,6217465,27793,0,36101
688,26167,0,61,0,26167,6243632,27768,0,36065
689,26241,0,74,0,26241,6269873,27725,0,36034
690,26301,0,60,0,26301,6296174,27701,0,35998
691,26360,0,59,0,26360,6322534,27677,0,35963
692,26417,0,57,0,26417,6348951,27652,0,35931
693,26480,0,63,0,26480,6375431,27631,0,35889
694,26544,13228,64,57,26487,6388747,27660,0,35853
695,26534,0,47,0,26534,6415281,27643,0,35823
696,26602,0,68,0,26602,6441883,27613,0,35785
697,26668,0,66,0,26668,6468551,27582,0,35750
698,26731,0,63,0,26731,6495282,27553,0,35716
699,26789,0,58,0,26789,6522071,27529,0,35682
700,26862,0,73,0,26862,6548933,27502,0,35636
701,26924,0,62,0,26924,6575857,27473,0,35603
702,26992,96452,68,313,26679,6506397,27759,0,35562
703,26747,0,68,0,26747,6533144,27737,0,35516
704,26812,6110,65,32,26780,6553846,27742,0,35478
705,26833,0,53,0,26833,6580679,27716,0,35451
706,26894,0,61,0,26894,6607573,27691,0,35415
707,26952,0,58,0,26952,6634525,27668,0,35380
708,27012,0,60,0,27012,6661537,27642,0,35346
709,27062,0,50,0,27062,6688599,27623,0,35315
710,27128,0,66,0,27128,6715727,27590,0,35282
711,27202,0,74,0,27202,6742929,27555,0,35243
712,27273,0,71,0,27273,6770202,27523,0,35204
713,27331,0,58,0,27331,6797533,27498,0,35171
714,27386,0,55,0,27386,6824919,27471,0,35143
715,27431,0,45,0,27431,6852350,27456,0,35113
716,27493,0,62,0,27493,6879843,27427,0,35080
717,27563,0,70,0,27563,6907406,27395,0,35042
718,27625,433,62,2,27623,6934598,27367,0,35010
719,27687,0,64,0,27687,6962285,27334,0,34979
720,27745,773859,58,2150,25595,6216171,29459,0,34946
721,25669,0,74,0,25669,6241840,29425,0,34906
722,25728,113770,59,378,25350,6153798,29777,0,34873
723,25403,0,53,0,25403,6179201,29758,0,34839
724,25462,0,59,0,25462,6204663,29734,0,34804
725,25523,0,61,0,25523,6230186,29701,0,34776
726,25584,29597,61,107,25477,6226173,29773,0,34750
727,25552,0,75,0,25552,6251725,29746,0,34702
728,25621,0,69,0,25621,6277346,29716,0,34663
729,25672,0,51,0,25672,6303018,29693,0,34635
730,25732,0,60,0,25732,6328750,29664,0,34604
731,25789,0,57,0,25789,6354539,29635,0,34576
732,25850,0,61,0,25850,6380389,29606,0,34544
733,25902,0,52,0,25902,6406291,29575,0,34523
734,25955,0,53,0,25955,6432246,29550,0,34495
735,26026,0,71,0,26026,6458272,29520,0,34454
736,26073,0,47,0,26073,6484345,29501,0,34426
737,26141,39317,68,103,26038,6471169,29573,0,34389
738,26109,26890,71,124,25985,6470388,29662,0,34353
739,26058,0,73,0,26058,6496446,29629,0,34313
740,26120,0,62,0,26120,6522566,29607,0,34273
741,26179,0,59,0,26179,6548745,29582,0,34239
742,26244,0,65,0,26244,6574989,29543,0,34213
743,26307,0,63,0,26307,6601296,29516,0,34177
744,26383,0,76,0,26383,6627679,29479,0,34138
745,26443,0,60,0,26443,6654122,29453,0,34104
746,26509,3916,66,21,26488,6676715,29446,0,34066
747,26542,0,54,0,26542,6703257,29421,0,34037
748,26614,0,72,0,26614,6729871,29389,0,33997
749,26668,0,54,0,26668,6756539,29364,0,33968
750,26730,0,62,0,26730,6783269,29337,0,33933
751,26796,0,66,0,26796,6810065,29308,0,33896
752,26856,0,60,0,26856,6836921,29275,0,33869
753,26919,0,63,0,26919,6863840,29240,0,33841
754,26989,0,70,0,26989,6890829,29208,0,33803
755,27055,1186,66,5,27050,6916698,29172,0,33778
756,27109,0,59,0,27109,6943807,29145,0,33746
757,27182,0,73,0,27182,6970989,29114,0,33704
758,27245,90896,63,322,26923,6907338,29403,0,33674
759,26977,0,54,0,26977,6934315,29375,0,33648
760,27042,0,65,0,27042,6961357,29344,0,33614
761,27097,0,55,0,27097,6988454,29315,0,33588
762,27144,0,47,0,27144,7015598,29286,0,33570
763,27199,0,55,0,27199,7042797,29253,0,33548
764,27257,3466,58,15,27242,7066588,29245,0,33513
765,27314,0,72,0,27314,7093902,29215,0,33471
766,27379,605,65,3,27376,7120676,29185,0,33439
767,27443,37463,67,140,27303,7110656,29295,0,33402
768,27372,0,69,0,27372,7138028,29259,0,33369
769,27425,172237,53,563,26862,6993216,29799,0,33339
770,26928,0,66,0,26928,7020144,29770,0,33302
771,26993,0,65,0,26993,7047137,29737,0,33270
772,27046,0,53,0,27046,7074183,29715,0,33239
773,27116,0,70,0,27116,7101299,29676,0,33208
774,27181,3640,65,10,27171,7124840,29661,0,33168
775,27223,0,52,0,27223,7152063,29647,0,33130
776,27303,0,80,0,27303,7179366,29612,0,33085
777,27378,5061,75,23,27355,7201683,29603,0,33042
778,27423,0,68,0,27423,7229106,29567,0,33010
779,27495,689,72,4,27491,7255912,29526,0,32983
780,27559,0,68,0,27559,7283471,29489,0,32952
781,27623,0,64,0,27623,7311094,29461,0,32916
782,27684,14841,61,58,27626,7323937,29487,0,32887
783,27689,0,63,0,27689,7351626,29459,0,32852
784,27747,0,58,0,27747,7379373,29432,0,32821
785,27822,0,75,0,27822,7407195,29393,0,32785
786,27873,65855,51,205,27668,7369213,29571,0,32761
787,27723,0,55,0,27723,7396936,29543,0,32734
788,27776,0,53,0,27776,7424712,29519,0,32705
789,27830,0,54,0,27830,7452542,29501,0,32669
790,27895,0,65,0,27895,7480437,29469,0,32636
791,27962,0,67,0,27962,7508399,29432,0,32606
792,28017,0,55,0,28017,7536416,29412,0,32571
793,28067,0,50,0,28067,7564483,29390,0,32543
794,28132,78261,65,246,27886,7514354,29614,0,32500
795,27943,0,57,0,27943,7542297,29585,0,32472
796,28021,0,78,0,28021,7570318,29549,0,32430
797,28076,0,55,0,28076,7598394,29519,0,32405
798,28127,0,51,0,28127,7626521,29489,0,32384
799,28200,0,73,0,28200,7654721,29450,0,32350
800,28254,0,54,0,28254,7682975,29416,0,32330
801,28315,0,61,0,28315,7711290,29389,0,32296
802,28355,0,40,0,28355,7739645,29369,0,32276
803,28419,0,64,0,28419,7768064,29337,0,32244
804,28483,0,64,0,28483,7796547,29299,0,32218
805,28545,0,62,0,28545,7825092,29271,0,32184
806,28617,0,72,0,28617,7853709,29245,0,32138
807,28684,0,67,0,28684,7882393,29206,0,32110
808,28742,0,58,0,28742,7911135,29177,0,32081
809,28811,0,69,0,28811,7939946,29149,0,32040
810,28857,643514,46,1964,26893,7325289,31091,0,32016
811,26965,0,72,0,26965,7352254,31055,0,31980
812,27024,169831,59,532,26492,7209447,31550,0,31958
813,26557,0,65,0,26557,7236004,31512,0,31931
814,26622,0,65,0,26622,7262626,31478,0,31900
815,26680,181623,58,549,26131,7107683,32000,0,31869
816,26210,0,79,0,26210,7133893,31955,0,31835
817,26280,0,70,0,26280,7160173,31922,0,31798
818,26343,0,63,0,26343,7186516,31890,0,31767
819,26416,9832,73,45,26371,7203100,31898,0,31731
820,26432,0,61,0,26432,7229532,31869,0,31699
821,26503,87,71,1,26502,7255948,31832,0,31666
822,26570,134316,68,326,26244,7148202,32128,0,31628
823,26308,140432,64,428,25880,7034078,32528,0,31592
824,25950,0,70,0,25950,7060028,32489,0,31561
825,26028,1842,78,10,26018,7084214,32459,0,31523
826,26070,0,52,0,26070,7110284,32434,0,31496
827,26152,0,82,0,26152,7136436,32395,0,31453
828,26235,580862,83,2012,24223,6581809,34366,0,31411
829,24287,0,64,0,24287,6606096,34334,0,31379
830,24363,0,76,0,24363,6630459,34291,0,31346
831,24433,0,70,0,24433,6654892,34263,0,31304
832,24502,0,69,0,24502,6679394,34229,0,31269
833,24572,314778,70,802,23770,6389188,34996,0,31234
834,23838,122670,68,410,23428,6290356,35360,0,31212
835,23483,0,55,0,23483,6313839,35334,0,31183
836,23548,0,65,0,23548,6337387,35297,0,31155
837,23624,0,76,0,23624,6361011,35249,0,31127
838,23684,0,60,0,23684,6384695,35205,0,31111
839,23750,0,66,0,23750,6408445,35166,0,31084
840,23814,285651,64,811,23003,6146608,35939,0,31058
841,23078,0,75,0,23078,6169686,35900,0,31022
842,23142,0,64,0,23142,6192828,35864,0,30994
843,23203,0,61,0,23203,6216031,35827,0,30970
844,23272,88573,69,336,22936,6150730,36132,0,30932
845,23010,0,74,0,23010,6173740,36093,0,30897
846,23085,770,75,5,23080,6196055,36057,0,30863
847,23141,0,61,0,23141,6219196,36028,0,30831
848,23195,0,54,0,23195,6242391,35992,0,30813
849,23250,0,55,0,23250,6265641,35962,0,30788
850,23324,434,74,5,23319,6288531,35931,0,30750
851,23383,0,64,0,23383,6311914,35891,0,30726
852,23455,0,72,0,23455,6335369,35850,0,30695
853,23532,1854,77,10,23522,6357047,35814,0,30664
854,23590,0,68,0,23590,6380637,35775,0,30635
855,23652,0,62,0,23652,6404289,35740,0,30608
856,23718,0,66,0,23718,6428007,35699,0,30583
857,23781,0,63,0,23781,6451788,35667,0,30552
858,23855,21501,74,80,23775,6454142,35705,0,30520
859,23837,0,62,0,23837,6477979,35671,0,30492
860,23896,0,59,0,23896,6501875,35632,0,30472
861,23965,0,69,0,23965,6525840,35598,0,30437
862,24036,0,71,0,24036,6549876,35560,0,30404
863,24105,0,69,0,24105,6573981,35525,0,30370
864,24173,0,68,0,24173,6598154,35490,0,30337
865,24244,0,71,0,24244,6622398,35447,0,30309
866,24309,430,65,2,24307,6646277,35420,0,30273
867,24377,0,70,0,24377,6670654,35386,0,30237
868,24443,0,66,0,24443,6695097,35352,0,30205
869,24502,0,59,0,24502,6719599,35315,0,30183
870,24573,0,71,0,24573,6744172,35270,0,30157
871,24639,142,66,1,24638,6768669,35233,0,30129
872,24683,0,45,0,24683,6793352,35212,0,30105
873,24751,0,68,0,24751,6818103,35177,0,30072
874,24814,0,63,0,24814,6842917,35140,0,30046
875,24891,0,77,0,24891,6867808,35100,0,30009
876,24958,0,67,0,24958,6892766,35057,0,29985
877,25015,957495,57,2356,22659,5960286,37383,0,29958
878,22727,8656,68,39,22688,5974357,37387,0,29925
879,22757,772,69,3,22754,5996342,37347,0,29899
880,22826,0,72,0,22826,6019168,37310,0,29864
881,22878,0,52,0,22878,6042046,37277,0,29845
882,22958,0,80,0,22958,6065004,37236,0,29806
883,23046,0,88,0,23046,6088050,37185,0,29769
884,23107,0,61,0,23107,6111157,37150,0,29743
885,23177,0,70,0,23177,6134334,37110,0,29713
886,23241,0,64,0,23241,6157575,37073,0,29686
887,23296,0,55,0,23296,6180871,37043,0,29661
888,23363,0,67,0,23363,6204234,36999,0,29638
889,23413,0,50,0,23413,6227647,36968,0,29619
890,23466,0,53,0,23466,6251113,36940,0,29594
891,23540,0,74,0,23540,6274653,36900,0,29560
892,23611,0,71,0,23611,6298264,36861,0,29528
893,23660,0,49,0,23660,6321924,36835,0,29505
894,23737,0,77,0,23737,6345661,36796,0,29467
895,23801,1381501,64,4160,19641,4987961,40923,0,29436
896,19727,0,86,0,19727,5007688,40862,0,29411
897,19781,0,54,0,19781,5027469,40836,0,29383
898,19852,0,71,0,19852,5047321,40796,0,29352
899,19931,380,79,2,19929,5066872,40747,0,29324
900,19998,0,69,0,19998,5086870,40707,0,29295
901,20069,0,71,0,20069,5106939,40666,0,29265
902,20151,3806,82,13,20138,5123284,40632,0,29230
903,20189,0,51,0,20189,5143473,40604,0,29207
904,20263,0,74,0,20263,5163736,40554,0,29183
905,20327,0,64,0,20327,5184063,40518,0,29155
906,20387,0,60,0,20387,5204450,40485,0,29128
907,20467,0,80,0,20467,5224917,40431,0,29102
908,20538,0,71,0,20538,5245455,40393,0,29069
909,20622,15180,84,58,20564,5250897,40398,0,29038
910,20639,0,75,0,20639,5271536,40355,0,29006
911,20709,0,70,0,20709,5292245,40308,0,28983
912,20769,0,60,0,20769,5313014,40270,0,28961
913,20847,0,78,0,20847,5333861,40223,0,28930
914,20909,2521,62,13,20896,5352249,40201,0,28903
915,20963,0,67,0,20963,5373212,40160,0,28877
916,21023,3609,60,11,21012,5390626,40135,0,28853
917,21074,0,62,0,21074,5411700,40103,0,28823
918,21130,0,56,0,21130,5432830,40071,0,28799
919,21197,119726,67,369,20828,5334301,40404,0,28768
920,20891,0,63,0,20891,5355192,40371,0,28738
921,20968,0,77,0,20968,5376160,40320,0,28712
922,21040,0,72,0,21040,5397200,40281,0,28679
923,21104,0,64,0,21104,5418304,40249,0,28647
924,21178,247939,74,632,20546,5191543,40840,0,28614
925,20620,0,74,0,20620,5212163,40799,0,28581
926,20696,0,76,0,20696,5232859,40760,0,28544
927,20752,4351,56,13,20739,5249260,40741,0,28520
928,20811,961203,72,3062,17749,4308868,43759,0,28492
929,17829,0,80,0,17829,4326697,43709,0,28462
930,17891,0,62,0,17891,4344588,43674,0,28435
931,17959,0,68,0,17959,4362547,43637,0,28404
932,18034,0,75,0,18034,4380581,43586,0,28380
933,18094,0,60,0,18094,4398675,43548,0,28358
934,18179,0,85,0,18179,4416854,43490,0,28331
935,18251,0,72,0,18251,4435105,43445,0,28304
936,18328,0,77,0,18328,4453433,43397,0,28275
937,18399,0,71,0,18399,4471832,43352,0,28249
938,18457,0,58,0,18457,4490289,43325,0,28218
939,18535,27598,78,90,18445,4481226,43370,0,28185
940,18502,0,57,0,18502,4499728,43335,0,28163
941,18561,0,59,0,18561,4518289,43293,0,28146
942,18650,0,89,0,18650,4536939,43238,0,28112
943,18727,0,77,0,18727,4555666,43191,0,28082
944,18790,0,63,0,18790,4574456,43154,0,28056
945,18856,111413,66,307,18549,4481899,43426,0,28025
946,18620,0,71,0,18620,4500519,43382,0,27998
947,18690,0,70,0,18690,4519209,43344,0,27966
948,18771,0,81,0,18771,4537980,43302,0,27927
949,18833,0,62,0,18833,4556813,43267,0,27900
950,18901,0,68,0,18901,4575714,43223,0,27876
951,18977,0,76,0,18977,4594691,43172,0,27851
952,19042,0,65,0,19042,4613733,43134,0,27824
953,19110,0,68,0,19110,4632843,43090,0,27800
954,19186,0,76,0,19186,4652029,43048,0,27766
955,19248,0,62,0,19248,4671277,43012,0,27740
956,19321,0,73,0,19321,4690598,42972,0,27707
957,19384,12479,63,52,19332,4697503,42987,0,27681
958,19400,0,68,0,19400,4716903,42947,0,27653
959,19464,0,64,0,19464,4736367,42909,0,27627
960,19525,0,61,0,19525,4755892,42870,0,27605
961,19601,0,76,0,19601,4775493,42823,0,27576
962,19685,0,84,0,19685,4795178,42771,0,27544
963,19751,0,66,0,19751,4814929,42735,0,27514
964,19816,0,65,0,19816,4834745,42695,0,27489
965,19876,0,60,0,19876,4854621,42660,0,27464
966,19947,0,71,0,19947,4874568,42615,0,27438
967,20026,0,79,0,20026,4894594,42562,0,27412
968,20100,0,74,0,20100,4914694,42516,0,27384
969,20165,75593,65,218,19947,4859266,42696,0,27357
970,20013,0,66,0,20013,4879279,42659,0,27328
971,20075,0,62,0,20075,4899354,42617,0,27308
972,20145,0,70,0,20145,4919499,42583,0,27272
973,20218,0,73,0,20218,4939717,42537,0,27245
974,20278,0,60,0,20278,4959995,42506,0,27216
975,20342,0,64,0,20342,4980337,42470,0,27188
976,20443,111,101,1,20442,5000669,42409,0,27149
977,20509,0,67,0,20509,5021178,42368,0,27123
978,20573,0,64,0,20573,5041751,42322,0,27105
979,20665,0,92,0,20665,5062416,42254,0,27081
980,20757,0,92,0,20757,5083173,42194,0,27049
981,20828,0,71,0,20828,5104001,42152,0,27020
982,20899,0,71,0,20899,5124900,42111,0,26990
983,20971,0,72,0,20971,5145871,42076,0,26953
984,21045,0,74,0,21045,5166916,42035,0,26920
985,21110,21617,65,64,21046,5166409,42061,0,26893
986,21116,2579,70,11,21105,5184946,42032,0,26863
987,21165,142475,60,451,20714,5063636,42448,0,26838
988,20783,44683,69,143,20640,5039736,42549,0,26811
989,20692,0,52,0,20692,5060428,42520,0,26788
990,20759,0,67,0,20759,5081187,42473,0,26768
991,20840,160148,81,436,20404,4941879,42852,0,26744
992,20469,0,65,0,20469,4962348,42817,0,26714
993,20542,0,73,0,20542,4982890,42768,0,26690
994,20611,0,69,0,20611,5003501,42721,0,26668
995,20671,0,60,0,20671,5024172,42689,0,26640
996,20739,0,68,0,20739,5044911,42647,0,26614
997,20803,0,64,0,20803,5065714,42602,0,26595
998,20872,0,69,0,20872,5086586,42555,0,26573
999,20935,0,63,0,20935,5107521,42510,0,26555
1000,21002,0,67,0,21002,5128523,42466,0,26532
1001,21084,0,82,0,21084,5149607,42421,0,26495
1002,21162,0,78,0,21162,5170769,42367,0,26471
1003,21228,0,66,0,21228,5191997,42329,0,26443
1004,21281,0,53,0,21281,5213278,42295,0,26424
1005,21354,0,73,0,21354,5234632,42250,0,26396
1006,21423,0,69,0,21423,5256055,42207,0,26370
1007,21493,0,70,0,21493,5277548,42163,0,26344
1008,21554,0,61,0,21554,5299102,42123,0,26323
1009,21631,0,77,0,21631,5320733,42079,0,26290
1010,21694,0,63,0,21694,5342427,42037,0,26269
1011,21764,0,70,0,21764,5364191,41996,0,26240
1012,21833,0,69,0,21833,5386024,41955,0,26212
1013,21901,0,68,0,21901,5407925,41919,0,26180
1014,21962,0,61,0,21962,5429887,41880,0,26158
1015,22039,0,77,0,22039,5451926,41830,0,26131
1016,22110,0,71,0,22110,5474036,41778,0,26112
1017,22187,0,77,0,22187,5496223,41727,0,26086
1018,22250,2004,63,11,22239,5516469,41700,0,26061
1019,22308,0,69,0,22308,5538777,41657,0,26035
1020,22374,0,66,0,22374,5561151,41627,0,25999
1021,22432,0,58,0,22432,5583583,41590,0,25978
1022,22500,0,68,0,22500,5606083,41549,0,25951
1023,22588,0,88,0,22588,5628671,41495,0,25917
1024,22651,0,63,0,22651,5651322,41457,0,25892
1025,22722,0,71,0,22722,5674044,41414,0,25864
1026,22785,0,63,0,22785,5696829,41376,0,25839
1027,22841,0,56,0,22841,5719670,41339,0,25820
1028,22887,1413,46,12,22875,5741144,41321,0,25804
1029,22947,0,72,0,22947,5764091,41279,0,25774
1030,23019,0,72,0,23019,5787110,41230,0,25751
1031,23099,0,80,0,23099,5810209,41178,0,25723
1032,23158,0,59,0,23158,5833367,41148,0,25694
1033,23232,0,74,0,23232,5856599,41105,0,25663
1034,23299,0,67,0,23299,5879898,41070,0,25631
1035,23377,0,78,0,23377,5903275,41021,0,25602
1036,23438,0,61,0,23438,5926713,40986,0,25576
1037,23506,0,68,0,23506,5950219,40935,0,25559
1038,23563,747707,57,1924,21639,5226075,42822,0,25539
1039,21710,9,71,1,21709,5247776,42778,0,25513
1040,21785,0,76,0,21785,5269561,42736,0,25479
1041,21849,0,64,0,21849,5291410,42692,0,25459
1042,21922,0,73,0,21922,5313332,42644,0,25434
1043,21979,0,57,0,21979,5335311,42608,0,25413
1044,22052,0,73,0,22052,5357363,42555,0,25393
1045,22114,0,62,0,22114,5379477,42521,0,25365
1046,22192,0,78,0,22192,5401669,42467,0,25341
1047,22263,0,71,0,22263,5423932,42422,0,25315
1048,22324,267135,61,845,21479,5179121,43232,0,25289
1049,21539,0,60,0,21539,5200660,43199,0,25262
1050,21611,0,72,0,21611,5222271,43155,0,25234
1051,21670,0,59,0,21670,5243941,43119,0,25211
1052,21739,0,69,0,21739,5265680,43071,0,25190
1053,21808,0,69,0,21808,5287488,43034,0,25158
1054,21883,0,75,0,21883,5309371,42987,0,25130
1055,21954,0,71,0,21954,5331325,42948,0,25098
1056,22025,399899,71,1200,20825,4953451,44102,0,25073
1057,20894,0,69,0,20894,4974345,44063,0,25043
1058,20959,0,65,0,20959,4995304,44017,0,25024
1059,21027,6708,68,27,21000,5009623,44002,0,24998
1060,21057,0,57,0,21057,5030680,43964,0,24979
1061,21135,0,78,0,21135,5051815,43914,0,24951
1062,21223,386,88,4,21219,5072652,43860,0,24921
1063,21278,0,59,0,21278,5093930,43816,0,24906
1064,21354,0,76,0,21354,5115284,43766,0,24880
1065,21442,131,88,2,21440,5136595,43712,0,24848
1066,21514,4934,74,19,21495,5153175,43683,0,24822
1067,21562,0,67,0,21562,5174737,43642,0,24796
1068,21627,0,65,0,21627,5196364,43601,0,24772
1069,21693,193512,66,509,21184,5024545,44073,0,24743
1070,21244,0,60,0,21244,5045789,44030,0,24726
1071,21311,606,67,5,21306,5066494,43992,0,24702
1072,21379,0,73,0,21379,5087873,43952,0,24669
1073,21444,31091,65,114,21330,5078226,44033,0,24637
1074,21406,0,76,0,21406,5099632,43988,0,24606
1075,21481,0,75,0,21481,5121113,43935,0,24584
1076,21559,0,78,0,21559,5142672,43879,0,24562
1077,21629,0,70,0,21629,5164301,43838,0,24533
1078,21709,0,80,0,21709,5186010,43787,0,24504
1079,21777,0,68,0,21777,5207787,43741,0,24482
1080,21833,3811,56,14,21819,5225809,43720,0,24461
1081,21887,0,68,0,21887,5247696,43682,0,24431
1082,21956,8628,69,39,21917,5261024,43673,0,24410
1083,21974,0,57,0,21974,5282998,43638,0,24388
1084,22026,0,52,0,22026,5305024,43604,0,24370
1085,22100,0,74,0,22100,5327124,43554,0,24346
1086,22165,49599,65,122,22043,5299690,43629,0,24328
1087,22109,0,66,0,22109,5321799,43584,0,24307
1088,22175,0,66,0,22175,5343974,43542,0,24283
1089,22242,0,67,0,22242,5366216,43503,0,24255
1090,22299,0,57,0,22299,5388515,43468,0,24233
1091,22372,0,73,0,22372,5410887,43420,0,24208
1092,22456,0,84,0,22456,5433343,43368,0,24176
1093,22522,0,66,0,22522,5455865,43331,0,24147
1094,22593,0,71,0,22593,5478458,43285,0,24122
1095,22665,0,72,0,22665,5501123,43246,0,24089
1096,22739,0,74,0,22739,5523862,43198,0,24063
1097,22809,0,70,0,22809,5546671,43153,0,24038
1098,22893,0,84,0,22893,5569564,43098,0,24009
1099,22951,0,58,0,22951,5592515,43059,0,23990
1100,23028,0,77,0,23028,5615543,43008,0,23964
