Step,mass_grown,mass_burnt,trees_grown,trees_burnt,trees_count,trees_mass,ashes_count,ashes_mass,empty_count
100,5145,3284,83,62,5083,257069,19817,0,65100
101,5159,3156,76,67,5092,259072,19867,0,65041
102,5192,4475,100,77,5115,259789,19928,0,64957
103,5224,4212,109,87,5137,260801,19986,0,64877
104,5226,7397,89,117,5109,258630,20081,0,64810
105,5202,4057,93,76,5126,259775,20127,0,64747
106,5205,4184,79,88,5117,260796,20199,0,64684
107,5208,6018,91,89,5119,259986,20270,0,64611
108,5225,5027,106,97,5128,260184,20338,0,64534
109,5204,4301,76,76,5128,261087,20395,0,64477
110,5213,5658,85,99,5114,260642,20472,0,64414
111,5211,5325,97,105,5106,260528,20553,0,64341
112,5191,4115,85,77,5114,261604,20606,0,64280
113,5203,4204,89,83,5120,262603,20666,0,64214
114,5193,4669,73,91,5102,263127,20738,0,64160
115,5211,4725,109,83,5128,263613,20792,0,64080
116,5225,4427,97,75,5150,264411,20841,0,64009
117,5242,4395,92,79,5163,265258,20904,0,63933
118,5247,5715,84,94,5153,264790,20981,0,63866
119,5236,4586,83,77,5159,265440,21041,0,63800
120,5252,3002,93,60,5192,267690,21077,0,63731
121,5268,4474,76,84,5184,268484,21144,0,63672
122,5267,3465,83,68,5199,270286,21189,0,63612
123,5297,3959,98,74,5223,271624,21233,0,63544
124,5317,4752,94,82,5235,272189,21293,0,63472
125,5318,4298,83,81,5237,273209,21350,0,63413
126,5320,4179,83,77,5243,274350,21409,0,63348
127,5341,5796,98,100,5241,273895,21478,0,63281
128,5314,6033,73,102,5212,273176,21563,0,63225
129,5284,5564,72,99,5185,272896,21637,0,63178
130,5270,4231,85,71,5199,273935,21688,0,63113
131,5278,6235,79,106,5172,272978,21772,0,63056
132,5254,4772,82,93,5161,273460,21843,0,62996
133,5257,5638,96,94,5163,273079,21914,0,62923
134,5230,4919,67,78,5152,273390,21979,0,62869
135,5250,4431,98,71,5179,274209,22027,0,62794
136,5271,4916,92,79,5192,274564,22078,0,62730
137,5274,3748,82,77,5197,276090,22134,0,62669
138,5276,5817,79,103,5173,275549,22215,0,62612
139,5262,4566,89,79,5183,276245,22276,0,62541
140,5253,5732,70,101,5152,275766,22357,0,62491
141,5239,4376,87,74,5165,276629,22406,0,62429
142,5238,6358,73,105,5133,275509,22490,0,62377
143,5211,4787,78,84,5127,275933,22558,0,62315
144,5211,5123,84,94,5117,276021,22636,0,62247
145,5190,4247,73,74,5116,276964,22695,0,62189
146,5205,4691,89,82,5123,277478,22753,0,62124
147,5195,4291,72,75,5120,278382,22811,0,62069
148,5204,4398,84,80,5124,279188,22865,0,62011
149,5199,6975,75,104,5095,277412,22949,0,61956
150,5186,4361,91,82,5104,278237,23010,0,61886
151,5183,4691,79,86,5097,278729,23073,0,61830
152,5192,2901,95,58,5134,281020,23107,0,61759
153,5218,5757,84,99,5119,280481,23184,0,61697
154,5207,4597,88,85,5122,281091,23251,0,61627
155,5204,5121,82,79,5125,281174,23308,0,61567
156,5213,3750,88,58,5155,282637,23340,0,61505
157,5239,7283,84,112,5127,280593,23425,0,61448
158,5227,3913,100,70,5157,281907,23472,0,61371
159,5234,4479,77,88,5146,282662,23537,0,61317
160,5231,4898,85,92,5139,282995,23611,0,61250
161,5215,3523,76,69,5146,284687,23659,0,61195
162,5246,4583,100,87,5159,285350,23714,0,61127
163,5243,4294,84,73,5170,286299,23759,0,61071
164,5248,3555,78,67,5181,287992,23798,0,61021
165,5264,6122,83,108,5156,287134,23883,0,60961
166,5243,3448,87,63,5180,288929,23922,0,60898
167,5249,3561,69,67,5182,290617,23965,0,60853
168,5281,5656,99,88,5193,290242,24010,0,60797
169,5253,5198,60,94,5159,290297,24081,0,60760
170,5242,4805,83,89,5153,290734,24146,0,60701
171,5234,4595,81,94,5140,291373,24211,0,60649
172,5225,4817,85,86,5139,291781,24268,0,60593
173,5224,5891,85,88,5136,291114,24325,0,60539
174,5208,5039,72,86,5122,291283,24385,0,60493
175,5199,4224,77,78,5121,292258,24443,0,60436
176,5204,8988,83,128,5076,288474,24548,0,60376
177,5166,4589,90,76,5090,289051,24595,0,60315
178,5168,4365,78,69,5099,289854,24642,0,60259
179,5188,4485,89,80,5108,290557,24697,0,60195
180,5191,4513,83,83,5108,291235,24758,0,60134
181,5203,6269,95,102,5101,290169,24827,0,60072
182,5182,2352,81,52,5130,292999,24858,0,60012
183,5206,5202,76,96,5110,293003,24930,0,59960
184,5191,4424,81,80,5111,293770,24982,0,59907
185,5190,4654,79,81,5109,294306,25037,0,59854
186,5195,7053,86,106,5089,292448,25120,0,59791
187,5169,3972,80,64,5105,293645,25160,0,59735
188,5178,3716,73,66,5112,295107,25202,0,59686
189,5182,5546,70,95,5087,294743,25279,0,59634
190,5175,5133,88,89,5086,294785,25340,0,59574
191,5180,6909,94,99,5081,293056,25417,0,59502
192,5169,5688,88,83,5086,292537,25470,0,59444
193,5169,5449,83,91,5078,292257,25540,0,59382
194,5161,3801,83,60,5101,293617,25572,0,59327
195,5192,7098,91,96,5096,291711,25635,0,59269
196,5200,5063,104,85,5115,291848,25690,0,59195
197,5189,2839,74,42,5147,294198,25706,0,59147
198,5245,3674,98,64,5181,295769,25748,0,59071
199,5254,5327,73,94,5160,295696,25821,0,59019
200,5269,4469,109,83,5186,296496,25869,0,58945
201,5267,5225,81,78,5189,296538,25921,0,58890
202,5276,4738,87,86,5190,297076,25983,0,58827
203,5275,6341,85,117,5158,296010,26065,0,58777
204,5248,4371,90,83,5165,296887,26124,0,58711
205,5250,4625,85,84,5166,297512,26178,0,58656
206,5247,3205,81,67,5180,299554,26215,0,58605
207,5251,5870,71,91,5160,298935,26285,0,58555
208,5227,5134,67,81,5146,299028,26349,0,58505
209,5236,4563,90,81,5155,299701,26401,0,58444
210,5232,6698,77,126,5106,298235,26508,0,58386
211,5178,4150,72,82,5096,299263,26567,0,58337
212,5191,5204,95,91,5100,299250,26630,0,58270
213,5186,4776,86,74,5112,299660,26681,0,58207
214,5210,4911,98,89,5121,299959,26729,0,58150
215,5209,4374,88,71,5138,300794,26771,0,58091
216,5215,3835,77,63,5152,302174,26808,0,58040
217,5235,3842,83,62,5173,303567,26840,0,57987
218,5239,5209,66,97,5142,303597,26916,0,57942
219,5224,4562,82,70,5154,304259,26959,0,57887
220,5267,5383,113,84,5183,304143,27017,0,57800
221,5278,6251,95,88,5190,303170,27077,0,57733
222,5280,4666,90,70,5210,303784,27123,0,57667
223,5308,4516,98,85,5223,304576,27176,0,57601
224,5297,5220,74,83,5214,304653,27239,0,57547
225,5295,4883,81,78,5217,305065,27291,0,57492
226,5309,4247,92,78,5231,306127,27340,0,57429
227,5331,4713,100,89,5242,306745,27389,0,57369
228,5321,4297,79,78,5243,307769,27434,0,57323
229,5325,4667,82,79,5246,308427,27483,0,57271
230,5330,6509,84,97,5233,307248,27553,0,57214
231,5327,4946,94,81,5246,307629,27601,0,57153
232,5316,4449,70,72,5244,308496,27649,0,57107
233,5332,5920,88,103,5229,307908,27728,0,57043
234,5337,5719,108,80,5257,307526,27766,0,56977
235,5331,4906,74,84,5247,307951,27827,0,56926
236,5329,5208,82,96,5233,308072,27897,0,56870
237,5325,6075,92,87,5238,307322,27953,0,56809
238,5325,6233,87,106,5219,306414,28039,0,56742
239,5299,4341,80,79,5220,307372,28093,0,56687
240,5294,5685,74,95,5199,306981,28168,0,56633
241,5266,5534,67,91,5175,306713,28237,0,56588
242,5249,5110,74,79,5170,306852,28296,0,56534
243,5240,4289,70,74,5166,307803,28351,0,56483
244,5255,5249,89,87,5168,307809,28413,0,56419
245,5267,3861,99,88,5179,309215,28472,0,56349
246,5263,4664,84,83,5180,309814,28525,0,56295
247,5267,7150,87,104,5163,307931,28604,0,56233
248,5243,3553,80,73,5170,309621,28655,0,56175
249,5262,4358,92,77,5185,310525,28706,0,56109
250,5279,4128,94,66,5213,311676,28739,0,56048
251,5310,4186,97,96,5214,312800,28800,0,55986
252,5281,7385,67,120,5161,310696,28897,0,55942
253,5246,3831,85,74,5172,312111,28944,0,55884
254,5250,4915,78,83,5167,312446,29003,0,55830
255,5264,5873,97,97,5167,311837,29062,0,55771
256,5256,5482,89,85,5171,311611,29120,0,55709
257,5251,4819,80,84,5167,312043,29185,0,55648
258,5244,4311,77,83,5161,312976,29246,0,55593
259,5250,5732,89,101,5149,312494,29323,0,55528
260,5219,4745,70,89,5130,312968,29393,0,55477
261,5231,4539,101,72,5159,313660,29432,0,55409
262,5230,4574,71,69,5161,314316,29475,0,55364
263,5238,7259,77,122,5116,312295,29568,0,55316
264,5200,5384,84,91,5109,312111,29624,0,55267
265,5184,4398,75,81,5103,312897,29678,0,55219
266,5166,5098,63,90,5076,312965,29747,0,55177
267,5162,4935,86,77,5085,313192,29791,0,55124
268,5179,4053,94,79,5100,314318,29838,0,55062
269,5187,8194,87,126,5061,311311,29930,0,55009
270,5149,5336,88,80,5069,311124,29980,0,54951
271,5172,5671,103,92,5080,310625,30035,0,54885
272,5167,7452,87,97,5070,308340,30091,0,54839
273,5158,4505,88,73,5085,308993,30129,0,54786
274,5180,4156,95,71,5109,310017,30169,0,54722
275,5188,4680,79,74,5114,310525,30217,0,54669
276,5202,5720,88,90,5112,310007,30262,0,54626
277,5198,5060,86,63,5135,310145,30287,0,54578
278,5220,5584,85,80,5140,309781,30338,0,54522
279,5229,5898,89,96,5133,309112,30403,0,54464
280,5220,5279,87,80,5140,309053,30451,0,54409
281,5220,5639,80,93,5127,308634,30521,0,54352
282,5216,5119,89,83,5133,308731,30570,0,54297
283,5239,4796,106,74,5165,309174,30606,0,54229
284,5252,7127,87,91,5161,307299,30668,0,54171
285,5252,4993,91,85,5167,307558,30718,0,54115
286,5247,5629,80,88,5159,307176,30788,0,54053
287,5256,4135,97,79,5177,308297,30831,0,53992
288,5252,4559,75,87,5165,308990,30895,0,53940
289,5248,5791,83,89,5159,308447,30957,0,53884
290,5255,4526,96,79,5176,309176,30995,0,53829
291,5269,6267,93,98,5171,308178,31056,0,53773
292,5264,5172,93,87,5177,308270,31113,0,53710
293,5262,5584,85,85,5177,307948,31174,0,53649
294,5259,4406,82,70,5189,308801,31218,0,53593
295,5266,4795,77,80,5186,309272,31264,0,53550
296,5258,5892,72,97,5161,308638,31338,0,53501
297,5250,5061,89,90,5160,308827,31397,0,53443
298,5243,4299,83,71,5172,309771,31438,0,53390
299,5247,4833,75,70,5177,310185,31480,0,53343
300,5258,4920,81,84,5174,310523,31536,0,53290
301,5271,7785,97,106,5165,308009,31599,0,53236
302,5265,4743,100,78,5187,308531,31650,0,53163
303,5268,6176,81,94,5174,307623,31719,0,53107
304,5253,4058,79,81,5172,308818,31775,0,53053
305,5257,5454,85,79,5178,308621,31818,0,53004
306,5262,7262,84,113,5149,306621,31900,0,52951
307,5218,4995,69,86,5132,306844,31954,0,52914
308,5213,4024,81,77,5136,308033,31997,0,52867
309,5231,6405,95,107,5124,306859,32073,0,52803
310,5188,3761,64,65,5123,308286,32113,0,52764
311,5231,4876,108,84,5147,308641,32162,0,52691
312,5230,3784,83,71,5159,310087,32197,0,52644
313,5249,5786,90,94,5155,309550,32265,0,52580
314,5249,4529,94,74,5175,310270,32306,0,52519
315,5272,5182,97,91,5181,310360,32356,0,52463
316,5265,2997,84,62,5203,312628,32387,0,52410
317,5301,6556,98,95,5206,311373,32450,0,52344
318,5286,3766,80,74,5212,312893,32493,0,52295
319,5293,5653,81,85,5208,312533,32550,0,52242
320,5293,4171,85,65,5228,313655,32584,0,52188
321,5308,4404,80,73,5235,314559,32622,0,52143
322,5324,5115,89,93,5231,314768,32679,0,52090
323,5315,4182,84,79,5236,315901,32726,0,52038
324,5309,5378,73,80,5229,315832,32782,0,51989
325,5308,4959,79,82,5226,316181,32830,0,51944
326,5314,5112,88,78,5236,316383,32876,0,51888
327,5319,8076,83,113,5206,313626,32956,0,51838
328,5301,6710,95,93,5208,312217,33013,0,51779
329,5282,4630,74,71,5211,312869,33057,0,51732
330,5294,4550,83,87,5207,313613,33119,0,51674
331,5296,3475,89,61,5235,315434,33147,0,51618
332,5317,7516,82,121,5196,313235,33236,0,51568
333,5283,6507,87,115,5168,312011,33313,0,51519
334,5251,4374,83,90,5161,312888,33373,0,51466
335,5240,6807,79,106,5134,311321,33450,0,51416
336,5221,5521,87,99,5122,311021,33518,0,51360
337,5204,6560,82,93,5111,309665,33576,0,51313
338,5184,4143,73,77,5107,310706,33623,0,51270
339,5184,3967,77,63,5121,311923,33655,0,51224
340,5199,5944,78,98,5101,311178,33722,0,51177
341,5173,5600,72,79,5094,310751,33773,0,51133
342,5172,6480,78,95,5077,309443,33843,0,51080
343,5167,6349,90,96,5071,308261,33910,0,51019
344,5154,4815,83,79,5075,308600,33957,0,50968
345,5158,4436,83,67,5091,309322,33997,0,50912
346,5186,5137,95,90,5096,309371,34050,0,50854
347,5176,6967,80,116,5060,307580,34137,0,50803
348,5152,3609,92,75,5077,309123,34180,0,50743
349,5144,5336,67,82,5062,308931,34232,0,50706
350,5144,6476,82,106,5038,307599,34312,0,50650
351,5121,5596,83,87,5034,307124,34367,0,50599
352,5108,6067,74,88,5020,306165,34424,0,50556
353,5094,4114,74,81,5013,307145,34475,0,50512
354,5102,5008,89,78,5024,307239,34512,0,50464
355,5100,3860,76,53,5047,308479,34541,0,50412
356,5119,4685,72,80,5039,308913,34585,0,50376
357,5117,3226,78,48,5069,310804,34604,0,50327
358,5156,3421,87,62,5094,312539,34629,0,50277
359,5184,4669,90,79,5105,313054,34679,0,50216
360,5193,4825,88,73,5120,313422,34713,0,50167
361,5202,3746,82,67,5135,314878,34742,0,50123
362,5210,4817,75,81,5129,315271,34787,0,50084
363,5215,4944,86,91,5124,315542,34841,0,50035
364,5222,5048,98,73,5149,315716,34870,0,49981
365,5253,4430,104,69,5184,316539,34892,0,49924
366,5280,4361,96,77,5203,317458,34929,0,49868
367,5286,5078,83,84,5202,317666,34975,0,49823
368,5299,4265,97,76,5223,318700,35011,0,49766
369,5315,5014,92,90,5225,319001,35056,0,49719
370,5312,3769,87,66,5246,320544,35086,0,49668
371,5330,6573,84,104,5226,319301,35157,0,49617
372,5289,4761,63,84,5205,319829,35211,0,49584
373,5289,6129,84,95,5194,318989,35276,0,49530
374,5291,6803,97,102,5189,317477,35338,0,49473
375,5288,6605,99,99,5189,316160,35393,0,49418
376,5264,5275,75,92,5172,316149,35450,0,49378
377,5263,4293,91,71,5192,317119,35482,0,49326
378,5272,4860,80,80,5192,317531,35532,0,49276
379,5285,4835,93,69,5216,317981,35568,0,49216
380,5298,5610,82,78,5220,317669,35604,0,49176
381,5311,2697,91,53,5258,320283,35625,0,49117
382,5338,5242,80,86,5252,320379,35683,0,49065
383,5329,5439,77,81,5248,320269,35730,0,49022
384,5334,6554,86,90,5244,319049,35784,0,48972
385,5333,7354,89,115,5218,317028,35856,0,48926
386,5312,6708,94,103,5209,315632,35917,0,48874
387,5291,4124,82,83,5208,316799,35963,0,48829
388,5291,6437,83,116,5175,315653,36048,0,48777
389,5263,4156,88,73,5190,316760,36079,0,48731
390,5272,4889,82,86,5186,317143,36127,0,48687
391,5277,4567,91,66,5211,317853,36163,0,48626
392,5303,7801,92,108,5195,315355,36229,0,48576
393,5289,6173,94,92,5197,314471,36289,0,48514
394,5256,5815,59,90,5166,313912,36352,0,48482
395,5247,5233,81,73,5174,313926,36383,0,48443
396,5247,4448,73,71,5176,314725,36422,0,48402
397,5269,6004,93,104,5165,313990,36489,0,48346
398,5230,3973,65,67,5163,315247,36530,0,48307
399,5243,4396,80,70,5173,316094,36567,0,48260
400,5248,6175,75,96,5152,315167,36628,0,48220
401,5225,5717,73,91,5134,314675,36679,0,48187
402,5229,4991,95,74,5155,314913,36716,0,48129
403,5247,4377,92,71,5176,315783,36746,0,48078
404,5248,3066,72,64,5184,317965,36784,0,48032
405,5283,5457,99,81,5202,317791,36824,0,47974
406,5285,5357,83,83,5202,317719,36875,0,47923
407,5269,5708,67,83,5186,317280,36932,0,47882
408,5272,6230,86,98,5174,316322,36995,0,47831
409,5246,3798,72,79,5167,317770,37041,0,47792
410,5257,2922,90,65,5192,320105,37070,0,47738
411,5270,5674,78,98,5172,319701,37141,0,47687
412,5271,4993,99,91,5180,319979,37188,0,47632
413,5266,3853,86,67,5199,321392,37214,0,47587
414,5282,5234,83,77,5205,321440,37258,0,47537
415,5285,6255,80,86,5199,320470,37311,0,47490
416,5267,5128,68,90,5177,320609,37370,0,47453
417,5264,5050,87,87,5177,320823,37418,0,47405
418,5258,4880,81,77,5181,321201,37470,0,47349
419,5256,3264,75,54,5202,323193,37487,0,47311
420,5283,5959,81,94,5189,322517,37539,0,47272
421,5271,7537,82,101,5170,320251,37604,0,47226
422,5269,3185,99,62,5207,322335,37622,0,47171
423,5289,5753,82,88,5201,321871,37678,0,47121
424,5281,4605,80,82,5199,322547,37726,0,47075
425,5288,5974,89,94,5194,321861,37777,0,47029
426,5275,5121,81,92,5183,322015,37833,0,46984
427,5265,5241,82,81,5184,322039,37873,0,46943
428,5284,5841,100,93,5191,321482,37920,0,46889
429,5285,4442,94,58,5227,322325,37935,0,46838
430,5321,6419,94,91,5230,321227,37994,0,46776
431,5333,5865,103,93,5240,320695,38039,0,46721
432,5326,4816,86,90,5236,321205,38084,0,46680
433,5316,6320,80,101,5215,320201,38152,0,46633
434,5290,4266,75,73,5217,321225,38192,0,46591
435,5294,3421,77,64,5230,323098,38230,0,46540
436,5315,6326,85,94,5221,322087,38285,0,46494
437,5305,3932,84,64,5241,323460,38313,0,46446
438,5328,8132,87,113,5215,320656,38384,0,46401
439,5308,6220,93,102,5206,319744,38446,0,46348
440,5290,3486,84,54,5236,321548,38469,0,46295
441,5315,2633,79,51,5264,324230,38492,0,46244
442,5342,6428,78,97,5245,323144,38547,0,46208
443,5318,4190,73,76,5242,324272,38590,0,46168
444,5345,6704,103,108,5237,322913,38648,0,46115
445,5311,4483,74,81,5230,323741,38701,0,46069
446,5314,4789,84,75,5239,324266,38734,0,46027
447,5325,3637,86,75,5250,325954,38766,0,45984
448,5327,4513,77,61,5266,326768,38791,0,45943
449,5344,5745,78,88,5256,326367,38851,0,45893
450,5345,4925,89,72,5273,326787,38881,0,45846
451,5368,5208,95,75,5293,326947,38912,0,45795
452,5377,5051,84,93,5284,327273,38956,0,45760
453,5379,4091,95,72,5307,328561,38982,0,45711
454,5401,8092,94,113,5288,325870,39050,0,45662
455,5390,4208,102,70,5320,327052,39092,0,45588
456,5410,4505,90,71,5339,327957,39118,0,45543
457,5419,5501,80,102,5317,327875,39185,0,45498
458,5391,5814,74,104,5287,327452,39259,0,45454
459,5374,5134,87,78,5296,327692,39297,0,45407
460,5377,4869,81,87,5290,328200,39351,0,45359
461,5351,4523,61,85,5266,329028,39410,0,45324
462,5352,4996,86,77,5275,329384,39443,0,45282
463,5345,5408,70,95,5250,329321,39504,0,45246
464,5326,5613,76,91,5235,329034,39557,0,45208
465,5327,5019,92,80,5247,329342,39592,0,45161
466,5322,7727,75,114,5208,326937,39667,0,45125
467,5286,5388,78,84,5202,326835,39711,0,45087
468,5286,4646,84,71,5215,327475,39742,0,45043
469,5286,3632,71,69,5217,329129,39779,0,45004
470,5313,5528,96,75,5238,328914,39809,0,44953
471,5307,6503,69,100,5207,327718,39876,0,44917
472,5284,4369,77,73,5211,328633,39918,0,44871
473,5289,5661,78,90,5199,328261,39972,0,44829
474,5278,7748,79,112,5166,325791,40056,0,44778
475,5245,5705,79,80,5165,325331,40102,0,44733
476,5263,6387,98,94,5169,324207,40150,0,44681
477,5252,5545,83,92,5160,323914,40210,0,44630
478,5250,4993,90,81,5169,324171,40240,0,44591
479,5247,5431,78,101,5146,323987,40303,0,44551
480,5237,7552,91,117,5120,321672,40376,0,44504
481,5210,5503,90,81,5129,321379,40412,0,44459
482,5214,5635,85,88,5126,320958,40456,0,44418
483,5213,3866,87,87,5126,322305,40509,0,44365
484,5197,4031,71,72,5125,323471,40547,0,44328
485,5200,5571,75,78,5122,323100,40589,0,44289
486,5205,3841,83,72,5133,324464,40628,0,44239
487,5208,4689,75,84,5124,324983,40681,0,44195
488,5224,5500,100,71,5153,324707,40713,0,44134
489,5247,6488,94,89,5158,323466,40752,0,44090
490,5243,3181,85,62,5181,325528,40778,0,44041
491,5269,5303,88,87,5182,325494,40820,0,43998
492,5273,5270,91,71,5202,325497,40850,0,43948
493,5288,5548,86,88,5200,325237,40896,0,43904
494,5287,4478,87,78,5209,326046,40926,0,43865
495,5279,9391,70,106,5173,321934,40999,0,43828
496,5278,5529,105,87,5191,321683,41043,0,43766
497,5283,5299,92,83,5200,321667,41085,0,43715
498,5295,6562,95,92,5203,320400,41131,0,43666
499,5284,7009,81,109,5175,318675,41209,0,43616
500,5263,5572,88,85,5178,318366,41257,0,43565
501,5273,3940,95,76,5197,319699,41281,0,43522
502,5292,4592,95,83,5209,320399,41321,0,43470
503,5287,5702,78,86,5201,319984,41374,0,43425
504,5287,4571,86,75,5212,320700,41394,0,43394
505,5286,6458,74,96,5190,319528,41454,0,43356
506,5271,5477,81,85,5186,319322,41484,0,43330
507,5279,4374,93,78,5201,320227,41517,0,43282
508,5287,5668,86,90,5197,319846,41566,0,43237
509,5282,4968,85,73,5209,320160,41598,0,43193
510,5289,5393,80,77,5212,320056,41636,0,43152
511,5291,7208,79,92,5199,318139,41690,0,43111
512,5292,4282,93,66,5226,319149,41706,0,43068
513,5307,5408,81,87,5220,319048,41754,0,43026
514,5289,5650,69,87,5202,318687,41815,0,42983
515,5286,4351,84,73,5213,319622,41842,0,42945
516,5298,6318,85,94,5204,318602,41897,0,42899
517,5284,4993,80,94,5190,318893,41953,0,42857
518,5300,4505,110,86,5214,319688,41983,0,42803
519,5290,6647,76,118,5172,318331,42056,0,42772
520,5256,4947,84,77,5179,318640,42094,0,42727
521,5272,4744,93,89,5183,319168,42138,0,42679
522,5270,5801,87,92,5178,318637,42189,0,42633
523,5250,7314,72,106,5144,316573,42259,0,42597
524,5208,5140,64,82,5126,316641,42313,0,42561
525,5213,5603,87,93,5120,316251,42366,0,42514
526,5208,5764,88,83,5125,315695,42406,0,42469
527,5213,5140,88,95,5118,315768,42458,0,42424
528,5202,3769,84,57,5145,317201,42481,0,42374
529,5237,5066,92,79,5158,317372,42510,0,42332
530,5247,5861,89,84,5163,316758,42548,0,42289
531,5256,5158,93,86,5170,316856,42587,0,42243
532,5261,4403,91,92,5169,317714,42629,0,42202
533,5253,5508,84,96,5157,317459,42681,0,42162
534,5241,5470,84,95,5146,317230,42731,0,42123
535,5239,6640,93,99,5140,315829,42781,0,42079
536,5241,5625,101,88,5153,315445,42808,0,42039
537,5245,6205,92,96,5149,314485,42856,0,41995
538,5234,4682,85,84,5150,315037,42894,0,41956
539,5230,6875,80,112,5118,313392,42963,0,41919
540,5190,5672,72,93,5097,312910,43020,0,41883
541,5173,6427,76,96,5077,311656,43086,0,41837
542,5162,6008,85,81,5081,310810,43122,0,41797
543,5177,3414,96,56,5121,312573,43124,0,41755
544,5199,2672,78,54,5145,315100,43146,0,41709
545,5233,6007,88,95,5138,314326,43197,0,41665
546,5220,6193,82,86,5134,313353,43236,0,41630
547,5225,6902,91,93,5132,311676,43276,0,41592
548,5213,4663,81,75,5138,312226,43313,0,41549
549,5227,6320,89,84,5143,311133,43342,0,41515
550,5226,6516,83,109,5117,309843,43413,0,41470
551,5198,5392,81,84,5114,309649,43458,0,41428
552,5210,5841,96,78,5132,309018,43492,0,41376
553,5226,6769,94,95,5131,307475,43537,0,41332
554,5214,4245,83,67,5147,308444,43556,0,41297
555,5237,6847,90,100,5137,306834,43611,0,41252
556,5224,5133,87,82,5142,306925,43649,0,41209
557,5216,3515,74,71,5145,308626,43683,0,41172
558,5236,4696,91,90,5146,309166,43720,0,41134
559,5226,5567,80,76,5150,308825,43742,0,41108
560,5237,4486,87,84,5153,309576,43777,0,41070
561,5226,6330,73,94,5132,308472,43834,0,41034
562,5228,4881,96,87,5141,308819,43876,0,40983
563,5218,5594,77,83,5135,308443,43917,0,40948
564,5204,5810,69,91,5113,307837,43973,0,40914
565,5203,2963,90,61,5142,310077,43984,0,40874
566,5238,4651,96,80,5158,310664,44008,0,40834
567,5254,5630,96,99,5155,310288,44052,0,40793
568,5238,5654,83,91,5147,309872,44095,0,40758
569,5229,3946,82,65,5164,311155,44119,0,40717
570,5252,5789,88,94,5158,310618,44163,0,40679
571,5242,4066,84,73,5169,311794,44193,0,40638
572,5255,6085,86,92,5163,310964,44233,0,40604
573,5250,4663,87,79,5171,311551,44271,0,40558
574,5251,5876,80,93,5158,310926,44323,0,40519
575,5237,4373,79,61,5176,311790,44339,0,40485
576,5257,4762,81,78,5179,312285,44373,0,40448
577,5257,6335,78,95,5162,311207,44438,0,40400
578,5240,3897,78,75,5165,312550,44470,0,40365
579,5260,4844,95,75,5185,312966,44499,0,40316
580,5266,5903,81,85,5181,312329,44533,0,40286
581,5273,4077,92,78,5195,313525,44566,0,40239
582,5278,5392,83,78,5200,313411,44604,0,40196
583,5284,5523,84,98,5186,313172,44658,0,40156
584,5266,5255,80,87,5179,313183,44701,0,40120
585,5253,5520,74,91,5162,312916,44753,0,40085
586,5257,4760,95,77,5180,313413,44775,0,40045
587,5272,4566,92,76,5196,314119,44810,0,39994
588,5271,6711,75,115,5156,312679,44885,0,39959
589,5246,6082,90,87,5159,311843,44922,0,39919
590,5253,2893,94,62,5191,314203,44938,0,39871
591,5272,4656,81,88,5184,314819,44979,0,39837
592,5280,5312,96,93,5187,314787,45021,0,39792
593,5263,4841,76,83,5180,315209,45057,0,39763
594,5257,4813,77,79,5178,315653,45089,0,39733
595,5258,7251,80,110,5148,313660,45156,0,39696
596,5222,5082,74,78,5144,313800,45195,0,39661
597,5247,6205,103,105,5142,312842,45240,0,39618
598,5223,4972,81,80,5143,313093,45263,0,39594
599,5235,6214,92,97,5138,312114,45305,0,39557
600,5230,6376,92,99,5131,310968,45351,0,39518
601,5216,7009,85,96,5120,309175,45401,0,39479
602,5210,5723,90,86,5124,308662,45442,0,39434
603,5206,4637,82,86,5120,309231,45481,0,39399
604,5202,4336,82,76,5126,310097,45518,0,39356
605,5231,5815,105,110,5121,309513,45583,0,39296
606,5204,3645,83,69,5135,311072,45610,0,39255
607,5230,6135,95,92,5138,310167,45647,0,39215
608,5230,5925,92,94,5136,309472,45692,0,39172
609,5219,5543,83,74,5145,309148,45717,0,39138
610,5236,5126,91,84,5152,309258,45748,0,39100
611,5237,2683,85,48,5189,311812,45752,0,39059
612,5283,5597,94,82,5201,311498,45789,0,39010
613,5279,4567,78,85,5194,312210,45836,0,38970
614,5277,4633,83,85,5192,312854,45881,0,38927
615,5282,5432,90,92,5190,312704,45920,0,38890
616,5271,6102,81,71,5200,311873,45946,0,38854
617,5276,4911,76,86,5190,312238,45994,0,38816
618,5280,4790,90,80,5200,312728,46021,0,38779
619,5272,6437,72,100,5172,311563,46076,0,38752
620,5274,5174,102,78,5196,311663,46103,0,38701
621,5292,6898,96,105,5187,310057,46151,0,38662
622,5267,6216,80,93,5174,309108,46204,0,38622
623,5250,4563,76,74,5176,309795,46238,0,38586
624,5273,4647,97,69,5204,310421,46254,0,38542
625,5275,5250,71,91,5184,310446,46304,0,38512
626,5285,4987,101,78,5207,310744,46329,0,38464
627,5286,5027,79,80,5206,311003,46359,0,38435
628,5298,5682,92,100,5198,310619,46411,0,38391
629,5283,3530,85,67,5216,312372,46427,0,38357
630,5294,6017,78,101,5193,311649,46481,0,38326
631,5277,6399,84,91,5186,310527,46522,0,38292
632,5281,5960,95,87,5194,309848,46548,0,38258
633,5279,6729,85,116,5163,308398,46622,0,38215
634,5249,4771,86,71,5178,308876,46638,0,38184
635,5248,6416,70,93,5155,307708,46688,0,38157
636,5250,6536,95,98,5152,306422,46735,0,38113
637,5246,4852,94,83,5163,306816,46768,0,38069
638,5254,6630,91,95,5159,305440,46800,0,38041
639,5252,4590,93,71,5181,306102,46820,0,37999
640,5247,4171,66,76,5171,307178,46861,0,37968
641,5275,5876,104,101,5174,306577,46905,0,37921
642,5240,5250,66,79,5161,306567,46942,0,37897
643,5239,4998,78,70,5169,306808,46971,0,37860
644,5263,5358,94,94,5169,306713,47015,0,37816
645,5260,4209,91,65,5195,307764,47029,0,37776
646,5283,5340,88,83,5200,307707,47065,0,37735
647,5286,5732,86,100,5186,307261,47122,0,37692
648,5267,4882,81,92,5175,307646,47173,0,37652
649,5280,6097,105,110,5170,306829,47224,0,37606
650,5249,3100,79,57,5192,308978,47237,0,37571
651,5276,4793,84,80,5196,309461,47258,0,37546
652,5273,5887,77,91,5182,308847,47308,0,37510
653,5264,4706,82,65,5199,309405,47331,0,37470
654,5294,4522,95,71,5223,310177,47347,0,37430
655,5303,4497,80,83,5220,310983,47388,0,37392
656,5299,4054,79,82,5217,312228,47421,0,37362
657,5294,5226,77,79,5215,312296,47455,0,37330
658,5304,3699,89,68,5236,313901,47473,0,37291
659,5307,5707,71,99,5208,313501,47532,0,37260
660,5303,4313,95,64,5239,314491,47543,0,37218
661,5328,4219,89,64,5264,315600,47557,0,37179
662,5333,4642,69,94,5239,316291,47607,0,37154
663,5336,6077,97,97,5239,315550,47654,0,37107
664,5309,6184,70,84,5225,314675,47699,0,37076
665,5312,6251,87,98,5214,313736,47746,0,37040
666,5297,5385,83,87,5210,313648,47792,0,36998
667,5300,6781,90,97,5203,312167,47842,0,36955
668,5290,5101,87,78,5212,312356,47872,0,36916
669,5293,6935,81,103,5190,310714,47935,0,36875
670,5263,5775,73,88,5175,310202,47972,0,36853
671,5257,3574,82,73,5184,311885,48003,0,36813
672,5283,4789,99,84,5199,312379,48024,0,36777
673,5272,6810,73,97,5175,310841,48082,0,36743
674,5258,4030,83,78,5180,312069,48120,0,36700
675,5271,4521,91,84,5187,312819,48151,0,36662
676,5263,5036,76,78,5185,313046,48184,0,36631
677,5252,4977,67,75,5177,313321,48225,0,36598
678,5264,4351,87,79,5185,314234,48260,0,36555
679,5277,5042,92,77,5200,314469,48289,0,36511
680,5282,6631,82,93,5189,313120,48344,0,36467
681,5278,4670,89,85,5193,313728,48380,0,36427
682,5265,6242,72,88,5177,312751,48424,0,36399
683,5269,4308,92,64,5205,313712,48437,0,36358
684,5290,6310,85,86,5204,312692,48478,0,36318
685,5287,3151,83,58,5229,314828,48491,0,36280
686,5326,6674,97,99,5227,313480,48532,0,36241
687,5311,5751,84,89,5222,313040,48571,0,36207
688,5301,4478,79,63,5238,313863,48591,0,36171
689,5322,5713,84,89,5233,313472,48638,0,36129
690,5316,6440,83,101,5215,312348,48687,0,36098
691,5291,6449,76,98,5193,311190,48744,0,36063
692,5255,6830,62,106,5149,309615,48805,0,36046
693,5241,7493,92,110,5131,307363,48858,0,36011
694,5236,4602,105,84,5152,307997,48881,0,35967
695,5237,5049,85,86,5151,308185,48913,0,35936
696,5255,4962,104,89,5166,308478,48941,0,35893
697,5241,4469,75,77,5164,309250,48983,0,35853
698,5247,4627,83,74,5173,309870,49014,0,35813
699,5258,5814,85,84,5174,309314,49042,0,35784
700,5261,4398,87,79,5182,310177,49069,0,35749
701,5267,4049,85,67,5200,311395,49088,0,35712
702,5288,5798,88,87,5201,310885,49120,0,35679
703,5288,5769,87,102,5186,310404,49165,0,35649
704,5279,4669,93,78,5201,311014,49196,0,35603
705,5271,5335,70,87,5184,310950,49242,0,35574
706,5269,7199,85,104,5165,309020,49300,0,35535
707,5250,4263,85,78,5172,310007,49324,0,35504
708,5259,6236,87,103,5156,309030,49372,0,35472
709,5246,4662,90,73,5173,309614,49394,0,35433
710,5256,4771,83,79,5177,310099,49419,0,35404
711,5268,8382,91,114,5154,306985,49478,0,35368
712,5233,6089,79,106,5127,306129,49533,0,35340
713,5203,5092,76,82,5121,306240,49570,0,35309
714,5223,7033,102,99,5124,304430,49616,0,35260
715,5213,4617,89,89,5124,305026,49658,0,35218
716,5199,3097,75,60,5139,307128,49680,0,35181
717,5231,7956,92,98,5133,304403,49731,0,35136
718,5207,5458,74,76,5131,304152,49765,0,35104
719,5210,4824,79,83,5127,304538,49808,0,35065
720,5197,7247,70,117,5080,302488,49879,0,35041
721,5145,5011,65,84,5061,302622,49925,0,35014
722,5154,5415,93,79,5075,302361,49952,0,34973
723,5163,5975,88,79,5084,301549,49979,0,34937
724,5159,4398,75,82,5077,302310,50016,0,34907
725,5158,5996,81,89,5069,301472,50058,0,34873
726,5170,4689,101,74,5096,301953,50063,0,34841
727,5184,4587,88,77,5107,302550,50090,0,34803
728,5195,3732,88,76,5119,304013,50124,0,34757
729,5209,3858,90,74,5135,305364,50148,0,34717
730,5227,3749,92,64,5163,306842,50160,0,34677
731,5256,5190,93,80,5176,306908,50184,0,34640
732,5260,6232,84,97,5163,305936,50228,0,34609
733,5260,4441,97,77,5183,306755,50256,0,34561
734,5269,7362,86,113,5156,304662,50320,0,34524
735,5233,6572,77,100,5133,303323,50382,0,34485
736,5224,5951,91,88,5136,302596,50422,0,34442
737,5229,5850,93,78,5151,301975,50451,0,34398
738,5237,5641,86,93,5144,301571,50490,0,34366
739,5230,6518,86,97,5133,300283,50540,0,34327
740,5216,5071,83,88,5128,300428,50577,0,34295
741,5218,5993,90,86,5132,299653,50607,0,34261
742,5218,2967,86,60,5158,301904,50605,0,34237
743,5237,5329,79,92,5145,301812,50648,0,34207
744,5232,3885,87,69,5163,303159,50672,0,34165
745,5244,4000,81,67,5177,304403,50686,0,34137
746,5261,6111,84,94,5167,303553,50736,0,34097
747,5237,3785,70,77,5160,305005,50773,0,34067
748,5257,5247,97,81,5176,305015,50800,0,34024
749,5268,2689,92,52,5216,307594,50793,0,33991
750,5292,6771,76,108,5184,306115,50852,0,33964
751,5253,5049,69,77,5176,306319,50891,0,33933
752,5280,4764,104,72,5208,306835,50897,0,33895
753,5284,4306,76,71,5213,307813,50922,0,33865
754,5296,5806,83,93,5203,307303,50961,0,33836
755,5306,6941,103,102,5204,305668,50997,0,33799
756,5286,7849,82,102,5184,303105,51047,0,33769
757,5264,6188,80,83,5181,302181,51080,0,33739
758,5260,6455,79,98,5162,300986,51134,0,33704
759,5252,6024,90,114,5138,300214,51190,0,33672
760,5233,6230,95,91,5142,299217,51225,0,33633
761,5238,5929,96,103,5135,298526,51276,0,33589
762,5226,3649,91,70,5156,300103,51287,0,33557
763,5253,6520,97,104,5149,298836,51323,0,33528
764,5231,4285,82,81,5150,299782,51349,0,33501
765,5223,5064,73,80,5143,299941,51390,0,33467
766,5244,3875,101,72,5172,301310,51406,0,33422
767,5257,4271,85,70,5187,302296,51430,0,33383
768,5284,5056,97,82,5202,302524,51454,0,33344
769,5270,3975,68,80,5190,303819,51489,0,33321
770,5283,4163,93,77,5206,304939,51511,0,33283
771,5297,5980,91,82,5215,304256,51535,0,33250
772,5299,5598,84,108,5191,303957,51595,0,33214
773,5269,4562,78,80,5189,304664,51627,0,33184
774,5284,4452,95,76,5208,305496,51635,0,33157
775,5289,5276,81,88,5201,305509,51676,0,33123
776,5298,5309,97,90,5208,305498,51710,0,33082
777,5299,4630,91,83,5216,306167,51732,0,33052
778,5308,3791,92,68,5240,307684,51747,0,33013
779,5326,4324,86,88,5238,308686,51785,0,32977
780,5325,5551,87,92,5233,308460,51826,0,32941
781,5315,5342,82,86,5229,308433,51868,0,32903
782,5307,5177,78,83,5224,308563,51910,0,32866
783,5298,5547,74,95,5203,308314,51951,0,32846
784,5293,4860,90,72,5221,308747,51969,0,32810
785,5300,7335,79,130,5170,306712,52053,0,32777
786,5255,7179,85,115,5140,304788,52122,0,32738
787,5222,5978,82,86,5136,304032,52154,0,32710
788,5217,5406,81,96,5121,303843,52198,0,32681
789,5191,3998,70,75,5116,305036,52230,0,32654
790,5189,5771,73,90,5099,304454,52276,0,32625
791,5165,6186,66,91,5074,303433,52330,0,32596
792,5148,4704,74,78,5070,303877,52362,0,32568
793,5158,6569,88,104,5054,302466,52414,0,32532
794,5136,4516,82,68,5068,303086,52429,0,32503
795,5141,6912,73,95,5046,301315,52476,0,32478
796,5132,6636,86,103,5029,299811,52524,0,32447
797,5116,4452,87,78,5038,300475,52542,0,32420
798,5110,6471,72,94,5016,299114,52597,0,32387
799,5086,5008,70,84,5002,299192,52642,0,32356
800,5098,6063,96,89,5009,298227,52670,0,32321
801,5104,3798,95,63,5041,299533,52678,0,32281
802,5114,5213,73,97,5017,299434,52730,0,32253
803,5092,6986,75,102,4990,297540,52776,0,32234
804,5088,3869,98,67,5021,298759,52780,0,32199
805,5099,4410,78,75,5024,299448,52810,0,32166
806,5110,5978,86,88,5022,298580,52841,0,32137
807,5125,5301,103,94,5031,298404,52870,0,32099
808,5122,5394,91,99,5023,298132,52911,0,32066
809,5091,7353,68,111,4980,295870,52979,0,32041
810,5069,7301,89,108,4961,293638,53033,0,32006
811,5049,5157,88,89,4960,293530,53057,0,31983
812,5047,4586,87,84,4963,293991,53088,0,31949
813,5048,5233,85,83,4965,293806,53115,0,31920
814,5046,5197,81,86,4960,293655,53141,0,31899
815,5040,4980,80,79,4961,293715,53180,0,31859
816,5041,5794,80,90,4951,292962,53225,0,31824
817,5035,4875,84,70,4965,293122,53240,0,31795
818,5041,7094,76,108,4933,291069,53298,0,31769
819,5019,6108,86,105,4914,289980,53344,0,31742
820,4983,3510,69,68,4915,291453,53369,0,31716
821,4993,6120,78,90,4903,290326,53415,0,31682
822,5010,4382,107,77,4933,290954,53423,0,31644
823,5009,5897,76,93,4916,290066,53470,0,31614
824,5002,3892,86,86,4916,291176,53504,0,31580
825,5007,5042,91,73,4934,291141,53509,0,31557
826,5027,5431,93,84,4943,290737,53532,0,31525
827,5021,6520,78,98,4923,289238,53582,0,31495
828,5004,4889,81,89,4915,289353,53616,0,31469
829,4991,5332,76,82,4909,289012,53645,0,31446
830,4984,7294,75,102,4882,286702,53693,0,31425
831,4969,4196,87,77,4892,287475,53714,0,31394
832,4967,4795,75,71,4896,287647,53743,0,31361
833,4973,6056,77,93,4880,286564,53787,0,31333
834,4973,4025,93,67,4906,287512,53797,0,31297
835,4997,4905,91,80,4917,287604,53825,0,31258
836,5016,5644,99,85,4931,286976,53855,0,31214
837,5028,3742,97,79,4949,288262,53870,0,31181
838,5018,3197,69,63,4955,290083,53886,0,31159
839,5040,3558,85,58,4982,291565,53892,0,31126
840,5057,4076,75,68,4989,292546,53909,0,31102
841,5083,5165,94,78,5005,292464,53928,0,31067
842,5081,4385,76,85,4996,293160,53967,0,31037
843,5073,4998,77,81,4992,293235,54002,0,31006
844,5073,4376,81,70,5003,293932,54034,0,30963
845,5109,4830,106,85,5024,294211,54050,0,30926
846,5124,6470,100,92,5032,292865,54083,0,30885
847,5102,4585,70,78,5024,293382,54118,0,30858
848,5109,4178,85,76,5033,294313,54142,0,30825
849,5112,4668,79,77,5035,294757,54164,0,30801
850,5120,4756,85,83,5037,295121,54190,0,30773
851,5132,4483,95,67,5065,295770,54204,0,30731
852,5148,4286,83,78,5070,296632,54234,0,30696
853,5152,4723,82,83,5069,297061,54264,0,30667
854,5143,6748,74,115,5028,295456,54327,0,30645
855,5110,4168,82,80,5030,296398,54359,0,30611
856,5116,4668,86,79,5037,296846,54386,0,30577
857,5114,4853,77,89,5025,297107,54427,0,30548
858,5110,5318,85,76,5034,296899,54448,0,30518
859,5112,3159,78,57,5055,298852,54455,0,30490
860,5121,5500,66,98,5023,298473,54519,0,30458
861,5114,3537,91,67,5047,300050,54525,0,30428
862,5132,4810,85,83,5049,300372,54559,0,30392
863,5129,5897,80,79,5050,299604,54585,0,30365
864,5139,4964,89,77,5062,299779,54607,0,30331
865,5142,4119,80,69,5073,300802,54629,0,30298
866,5158,4363,85,73,5085,301597,54647,0,30268
867,5156,3157,71,65,5091,303596,54666,0,30243
868,5160,5856,69,96,5064,302900,54720,0,30216
869,5146,5243,82,75,5071,302803,54745,0,30184
870,5147,3783,76,71,5076,304167,54762,0,30162
871,5145,5760,69,91,5054,303552,54808,0,30138
872,5135,4243,81,83,5052,304444,54840,0,30108
873,5120,5984,68,80,5040,303580,54881,0,30079
874,5134,4572,94,81,5053,304142,54898,0,30049
875,5137,4128,84,61,5076,305151,54907,0,30017
876,5156,4816,80,69,5087,305491,54923,0,29990
877,5164,7688,77,106,5058,302967,54976,0,29966
878,5138,5254,80,81,5057,302851,55005,0,29938
879,5143,4402,86,70,5073,303592,55017,0,29910
880,5173,6640,100,109,5064,302125,55058,0,29878
881,5157,4693,93,90,5067,302589,55089,0,29844
882,5159,4688,92,89,5070,303060,55122,0,29808
883,5138,4707,68,73,5065,303491,55146,0,29789
884,5143,5901,78,90,5053,302733,55186,0,29761
885,5137,5735,84,88,5049,302135,55217,0,29734
886,5127,4138,78,80,5047,303124,55242,0,29711
887,5141,5298,94,97,5044,302967,55278,0,29678
888,5120,5337,76,85,5035,302750,55312,0,29653
889,5133,3816,98,66,5067,304067,55309,0,29624
890,5161,5642,94,97,5064,303586,55345,0,29591
891,5148,4669,84,69,5079,304065,55364,0,29557
892,5153,7032,74,95,5058,302186,55410,0,29532
893,5139,3897,81,69,5070,303428,55419,0,29511
894,5152,6115,82,92,5060,302465,55459,0,29481
895,5146,4499,86,73,5073,303112,55483,0,29444
896,5151,3596,78,61,5090,304667,55492,0,29418
897,5179,5659,89,104,5075,304187,55534,0,29391
898,5170,5094,95,73,5097,304263,55540,0,29363
899,5176,4939,79,81,5095,304500,55570,0,29335
900,5208,5117,113,70,5138,304591,55567,0,29295
901,5210,4652,72,84,5126,305149,55604,0,29270
902,5209,4408,83,60,5149,305950,55611,0,29240
903,5237,7327,88,109,5128,303860,55675,0,29197
904,5214,6847,86,102,5112,302227,55723,0,29165
905,5215,5203,103,89,5126,302239,55740,0,29134
906,5211,6722,85,85,5126,300728,55771,0,29103
907,5205,4408,79,82,5123,301525,55804,0,29073
908,5187,6608,64,110,5077,300104,55870,0,29053
909,5165,4568,88,77,5088,300701,55888,0,29024
910,5170,5866,82,79,5091,300005,55914,0,28995
911,5166,7381,75,111,5055,297790,55973,0,28972
912,5133,5467,78,90,5043,297456,56004,0,28953
913,5138,7291,95,107,5031,295303,56054,0,28915
914,5116,3943,85,73,5043,296476,56069,0,28888
915,5133,2647,90,51,5082,298962,56064,0,28854
916,5178,3482,96,61,5117,300658,56070,0,28813
917,5200,5299,83,91,5109,300559,56111,0,28780
918,5183,4258,74,69,5114,301484,56130,0,28756
919,5179,6697,65,95,5084,299966,56185,0,28731
920,5155,5564,71,84,5071,299557,56224,0,28705
921,5156,5354,85,94,5062,299359,56258,0,28680
922,5147,7383,85,109,5038,297123,56307,0,28655
923,5122,6105,84,97,5025,296140,56341,0,28634
924,5114,3612,89,61,5053,297642,56333,0,28614
925,5137,4769,84,87,5050,298010,56364,0,28586
926,5144,5671,94,80,5064,297483,56382,0,28554
927,5152,4266,88,76,5076,298369,56406,0,28518
928,5167,5529,91,95,5072,298007,56446,0,28482
929,5161,3349,89,57,5104,299819,56445,0,28451
930,5188,6913,84,92,5096,298094,56482,0,28422
931,5171,4959,75,83,5088,298306,56515,0,28397
932,5164,4927,76,77,5087,298543,56548,0,28365
933,5176,4985,89,77,5099,298734,56571,0,28330
934,5186,3846,87,80,5106,300074,56590,0,28304
935,5205,6224,99,106,5099,299055,56634,0,28267
936,5198,6572,99,101,5097,297681,56662,0,28241
937,5183,5133,86,89,5094,297731,56696,0,28210
938,5166,4016,72,84,5082,298881,56733,0,28185
939,5167,6443,85,97,5070,297605,56776,0,28154
940,5144,4429,74,66,5078,298320,56791,0,28131
941,5167,3708,89,75,5092,299779,56809,0,28099
942,5173,2621,81,63,5110,302331,56819,0,28071
943,5197,5792,87,87,5110,301736,56842,0,28048
944,5171,4299,61,67,5104,302608,56867,0,28029
945,5198,6254,94,110,5088,301552,56910,0,28002
946,5169,4804,81,70,5099,301917,56922,0,27979
947,5187,6320,88,101,5086,300784,56965,0,27949
948,5147,5080,61,83,5064,300851,57009,0,27927
949,5138,5079,74,84,5054,300910,57046,0,27900
950,5139,5133,85,82,5057,300916,57080,0,27863
951,5134,4126,77,77,5057,301924,57105,0,27838
952,5141,8767,84,116,5025,298298,57167,0,27808
953,5110,5679,85,91,5019,297729,57203,0,27778
954,5109,3064,90,59,5050,299774,57205,0,27745
955,5135,3397,85,71,5064,301512,57224,0,27712
956,5157,4699,93,69,5088,301970,57231,0,27681
957,5169,5883,81,102,5067,301256,57268,0,27665
958,5168,6490,101,110,5058,299934,57323,0,27619
959,5142,5479,84,95,5047,299597,57367,0,27586
960,5145,5646,98,96,5049,299096,57395,0,27556
961,5122,5202,73,86,5036,299016,57431,0,27533
962,5111,5154,75,80,5031,298973,57454,0,27515
963,5111,4923,80,92,5019,299161,57491,0,27490
964,5095,4595,76,81,5014,299661,57524,0,27462
965,5092,4951,78,81,5011,299802,57550,0,27439
966,5091,3853,80,67,5024,301040,57571,0,27405
967,5109,4078,85,67,5042,302071,57580,0,27378
968,5123,4901,81,85,5038,302293,57613,0,27349
969,5124,5192,86,80,5044,302225,57633,0,27323
970,5129,6691,85,95,5034,300663,57670,0,27296
971,5124,6638,90,106,5018,299149,57705,0,27277
972,5113,5762,95,108,5005,298500,57755,0,27240
973,5081,6902,76,98,4983,296679,57796,0,27221
974,5075,6804,92,104,4971,294950,57832,0,27197
975,5033,5542,62,78,4955,294441,57869,0,27176
976,5042,6587,87,98,4944,292896,57912,0,27144
977,5020,4423,76,81,4939,293493,57943,0,27118
978,5035,5244,96,79,4956,293284,57960,0,27084
979,5033,5328,77,83,4950,292989,57986,0,27064
980,5030,4589,80,79,4951,293430,58006,0,27043
981,5044,4406,93,70,4974,294068,58017,0,27009
982,5057,6259,83,102,4955,292866,58062,0,26983
983,5037,3620,82,76,4961,294283,58080,0,26959
984,5047,5389,86,88,4959,293941,58112,0,26929
985,5042,4435,83,81,4961,294548,58139,0,26900
986,5045,5082,84,83,4962,294511,58162,0,26876
987,5039,4686,77,85,4954,294864,58188,0,26858
988,5052,4411,98,71,4981,295505,58201,0,26818
989,5067,7571,86,118,4949,293001,58266,0,26785
990,5028,4410,79,64,4964,293619,58281,0,26755
991,5039,5256,75,81,4958,293402,58313,0,26729
992,5032,7184,74,95,4937,291250,58352,0,26711
993,5035,5583,98,90,4945,290702,58379,0,26676
994,5022,5791,77,76,4946,289933,58404,0,26650
995,5024,4488,78,81,4943,290469,58431,0,26626
996,5024,3913,81,68,4956,291580,58445,0,26599
997,5038,4926,82,67,4971,291692,58456,0,26573
998,5076,5677,105,102,4974,291091,58490,0,26536
999,5058,5854,84,80,4978,290295,58511,0,26511
1000,5075,5340,97,84,4991,290030,58528,0,26481
1001,5066,5862,75,99,4967,289234,58581,0,26452
1002,5056,5545,89,86,4970,288745,58609,0,26421
1003,5042,5569,72,77,4965,288218,58633,0,26402
1004,5048,5055,83,95,4953,288211,58671,0,26376
1005,5033,4167,80,70,4963,289077,58689,0,26348
1006,5038,6144,75,98,4940,287971,58735,0,26325
1007,5016,4361,76,78,4938,288626,58760,0,26302
1008,5029,4361,91,74,4955,289294,58766,0,26279
1009,5055,5849,100,89,4966,288500,58778,0,26256
1010,5047,4012,81,81,4966,289535,58799,0,26235
1011,5066,5934,100,96,4970,288667,58823,0,26207
1012,5057,4166,87,75,4982,289558,58833,0,26185
1013,5083,4258,101,80,5003,290383,58843,0,26154
1014,5089,5215,86,81,5008,290257,58865,0,26127
1015,5088,4749,80,74,5014,290596,58890,0,26096
1016,5099,5607,85,92,5007,290088,58927,0,26066
1017,5106,3879,99,70,5036,291315,58924,0,26040
1018,5134,5029,98,95,5039,291420,58946,0,26015
1019,5112,5384,73,85,5027,291148,58977,0,25996
1020,5112,5280,85,85,5027,290980,58994,0,25979
1021,5121,5032,94,82,5039,291069,59005,0,25956
1022,5121,4926,82,80,5041,291264,59032,0,25927
1023,5131,5196,90,84,5047,291199,59050,0,25903
1024,5134,4867,87,94,5040,291466,59089,0,25871
1025,5120,3130,80,56,5064,293456,59088,0,25848
1026,5149,6291,85,109,5040,292314,59136,0,25824
1027,5123,4703,83,77,5046,292734,59154,0,25800
1028,5144,5663,98,91,5053,292215,59174,0,25773
1029,5151,4711,98,74,5077,292655,59185,0,25738
1030,5173,6158,96,118,5055,291670,59238,0,25707
1031,5136,5763,81,102,5034,291043,59285,0,25681
1032,5131,5689,97,75,5056,290485,59293,0,25651
1033,5148,3651,92,69,5079,291982,59292,0,25629
1034,5169,5628,90,99,5070,291523,59329,0,25601
1035,5166,3764,96,73,5093,292925,59341,0,25566
1036,5158,5077,65,81,5077,293006,59374,0,25549
1037,5160,4727,83,74,5086,293439,59387,0,25527
1038,5164,5510,78,86,5078,293093,59428,0,25494
1039,5159,7184,81,118,5041,291068,59494,0,25465
1040,5140,4509,99,76,5064,291699,59506,0,25430
1041,5137,4325,73,77,5060,292511,59533,0,25407
1042,5136,4901,76,79,5057,292746,59564,0,25379
1043,5140,6532,83,102,5038,291354,59597,0,25365
1044,5118,4457,80,78,5040,292015,59619,0,25341
1045,5121,2954,81,45,5076,294182,59609,0,25315
1046,5169,4989,93,72,5097,294362,59623,0,25280
1047,5189,5365,92,98,5091,294186,59653,0,25256
1048,5171,6218,80,103,5068,293139,59701,0,25231
1049,5154,6199,86,95,5059,292094,59734,0,25207
1050,5142,5484,83,94,5048,291752,59768,0,25184
1051,5124,5016,76,85,5039,291860,59798,0,25163
1052,5127,4191,88,80,5047,292796,59820,0,25133
1053,5141,5206,94,84,5057,292731,59833,0,25110
1054,5132,6096,75,100,5032,291767,59890,0,25078
1055,5122,4316,90,68,5054,292573,59892,0,25054
1056,5147,6111,93,94,5053,291609,59912,0,25035
1057,5139,4199,86,76,5063,292549,59928,0,25009
1058,5166,3036,103,60,5106,294679,59919,0,24975
1059,5176,4271,70,77,5099,295584,59945,0,24956
1060,5172,6022,73,96,5076,294734,59988,0,24936
1061,5150,6070,74,101,5049,293814,60040,0,24911
1062,5138,4395,89,88,5050,294557,60067,0,24883
1063,5142,4210,92,76,5066,295489,60085,0,24849
1064,5155,5759,89,96,5059,294885,60119,0,24822
1065,5139,4449,80,76,5063,295575,60148,0,24789
1066,5137,7114,74,105,5032,293598,60198,0,24770
1067,5103,5796,71,88,5015,292905,60240,0,24745
1068,5114,5007,99,100,5014,293012,60278,0,24708
1069,5111,5540,97,85,5026,292583,60293,0,24681
1070,5094,3986,68,71,5023,293691,60313,0,24664
1071,5121,4569,98,80,5041,294243,60322,0,24637
1072,5133,5097,92,81,5052,294279,60339,0,24609
1073,5137,5325,85,97,5040,294091,60376,0,24584
1074,5130,4751,90,86,5044,294470,60399,0,24557
1075,5139,5056,95,97,5042,294553,60432,0,24526
1076,5129,5333,87,79,5050,294349,60445,0,24505
1077,5127,4620,77,80,5047,294856,60472,0,24481
1078,5147,4594,100,77,5070,295409,60478,0,24452
1079,5146,3340,76,47,5099,297215,60466,0,24435
1080,5189,4039,90,80,5109,298365,60482,0,24409
1081,5200,4887,91,79,5121,298678,60500,0,24379
1082,5194,5285,73,85,5109,298587,60530,0,24361
1083,5208,5255,99,80,5128,298540,60543,0,24329
1084,5211,5889,83,91,5120,297862,60574,0,24306
1085,5202,4526,82,91,5111,298538,60604,0,24285
1086,5196,5231,85,86,5110,298503,60632,0,24258
1087,5220,4821,110,81,5139,298902,60634,0,24227
1088,5230,2956,91,66,5164,301176,60632,0,24204
1089,5249,5562,85,87,5162,300863,60659,0,24179
1090,5237,4202,75,76,5161,301898,60682,0,24157
1091,5238,7067,77,81,5157,300069,60706,0,24137
1092,5248,5502,91,83,5165,299815,60719,0,24116
1093,5272,4307,107,89,5183,300780,60736,0,24081
1094,5276,6030,93,93,5183,300026,60769,0,24048
1095,5276,5558,93,87,5189,299744,60790,0,24021
1096,5279,5019,90,92,5187,300004,60820,0,23993
1097,5263,6519,76,95,5168,298748,60857,0,23975
1098,5237,5567,69,78,5159,298418,60885,0,23956
1099,5256,4224,97,78,5178,299450,60904,0,23918
1100,5257,3766,79,66,5191,300941,60918,0,23891
