Step,mass_grown,mass_burnt,trees_grown,trees_burnt,trees_count,trees_mass,ashes_count,ashes_mass,empty_count
100,11112,1906,0,18,11094,1150641,6933,0,71973
101,11094,4825,0,46,11048,1156910,6979,0,71973
102,11048,2973,0,28,11020,1164985,7007,0,71973
103,11020,4153,0,40,10980,1171852,7047,0,71973
104,10983,2598,3,24,10959,1180237,7071,0,71970
105,10960,5994,1,55,10905,1185203,7126,0,71969
106,10907,5247,2,48,10859,1190863,7174,0,71967
107,10859,4979,0,45,10814,1196743,7219,0,71967
108,10814,2725,0,24,10790,1204832,7243,0,71967
109,10790,7587,0,67,10723,1208035,7310,0,71967
110,10723,6912,0,61,10662,1211846,7371,0,71967
111,10663,1840,1,16,10647,1220669,7387,0,71966
112,10648,2557,1,22,10626,1228760,7409,0,71965
113,10627,5441,1,47,10580,1233946,7456,0,71964
114,10582,3332,2,28,10554,1241196,7484,0,71962
115,10556,5877,2,50,10506,1245875,7534,0,71960
116,10506,4547,0,38,10468,1251834,7572,0,71960
117,10470,2786,2,23,10447,1259518,7595,0,71958
118,10448,732,1,6,10442,1269234,7601,0,71957
119,10442,8517,0,69,10373,1271159,7670,0,71957
120,10373,5942,0,48,10325,1275590,7718,0,71957
121,10326,2391,1,19,10307,1283525,7737,0,71956
122,10307,2511,0,20,10287,1291321,7757,0,71956
123,10288,3384,1,27,10261,1298225,7784,0,71955
124,10261,4131,0,32,10229,1304355,7816,0,71955
125,10230,6999,1,55,10175,1307586,7871,0,71954
126,10176,6501,1,50,10126,1311261,7921,0,71953
127,10126,6200,0,48,10078,1315187,7969,0,71953
128,10080,8414,2,64,10016,1316853,8032,0,71952
129,10018,2876,2,22,9996,1323995,8054,0,71950
130,9996,1616,0,12,9984,1332375,8066,0,71950
131,9984,3797,0,28,9956,1338562,8094,0,71950
132,9956,3380,0,25,9931,1345138,8119,0,71950
133,9932,6281,1,46,9886,1348789,8165,0,71949
134,9886,4845,0,35,9851,1353830,8200,0,71949
135,9851,5036,0,36,9815,1358645,8236,0,71949
136,9815,5325,0,38,9777,1363135,8274,0,71949
137,9778,5361,1,38,9740,1367552,8312,0,71948
138,9740,6387,0,45,9695,1370905,8357,0,71948
139,9695,4144,0,29,9666,1376456,8386,0,71948
140,9666,6475,0,45,9621,1379647,8431,0,71948
141,9622,4481,1,31,9591,1384788,8462,0,71947
142,9591,6865,0,47,9544,1387514,8509,0,71947
143,9544,5306,0,36,9508,1391752,8545,0,71947
144,9508,3994,0,27,9481,1397266,8572,0,71947
145,9482,7558,1,51,9431,1399190,8622,0,71947
146,9431,3909,0,26,9405,1404712,8648,0,71947
147,9405,2107,0,14,9391,1412010,8662,0,71947
148,9391,5241,0,35,9356,1416160,8697,0,71947
149,9357,5824,1,38,9319,1419693,8735,0,71946
150,9322,6611,3,43,9279,1422404,8778,0,71943
151,9281,6388,2,41,9240,1425297,8819,0,71941
152,9241,7323,1,47,9194,1427215,8866,0,71940
153,9194,154,0,1,9193,1436255,8867,0,71940
154,9193,5674,0,36,9157,1439774,8903,0,71940
155,9159,3470,2,22,9137,1445463,8925,0,71938
156,9138,3348,1,21,9117,1451253,8946,0,71937
157,9120,6252,3,39,9081,1454121,8985,0,71934
158,9083,1455,2,9,9074,1461749,8994,0,71932
159,9074,6966,0,44,9030,1463857,9038,0,71932
160,9031,9002,1,55,8976,1463886,9092,0,71932
161,8976,3291,0,20,8956,1469571,9112,0,71932
162,8956,5486,0,33,8923,1473041,9145,0,71932
163,8926,5166,3,31,8895,1476801,9175,0,71930
164,8895,4345,0,26,8869,1481351,9201,0,71930
165,8869,2701,0,16,8853,1487519,9217,0,71930
166,8853,697,0,4,8849,1495675,9221,0,71930
167,8849,4441,0,26,8823,1500083,9247,0,71930
168,8824,2931,1,17,8807,1505976,9264,0,71929
169,8810,7920,3,46,8764,1506866,9309,0,71927
170,8765,4010,1,23,8742,1511621,9332,0,71926
171,8744,5089,2,29,8715,1515276,9361,0,71924
172,8716,5277,1,30,8686,1518715,9391,0,71923
173,8686,7054,0,40,8646,1520347,9431,0,71923
174,8647,7106,1,40,8607,1521888,9471,0,71922
175,8608,1442,1,8,8600,1529054,9479,0,71921
176,8600,4844,0,27,8573,1532810,9506,0,71921
177,8574,4178,1,23,8551,1537206,9529,0,71920
178,8552,2187,1,12,8540,1543571,9541,0,71919
179,8541,7497,1,41,8500,1544615,9582,0,71918
180,8500,3672,0,21,8479,1549443,9603,0,71918
181,8481,4369,2,24,8457,1553555,9626,0,71917
182,8458,7410,1,40,8418,1554603,9666,0,71916
183,8419,11653,1,63,8356,1551369,9729,0,71915
184,8357,5958,1,32,8325,1553768,9761,0,71914
185,8326,2069,1,11,8315,1560025,9772,0,71913
186,8316,8703,1,46,8270,1559638,9818,0,71912
187,8273,3638,3,19,8254,1564273,9837,0,71909
188,8254,2691,0,14,8240,1569836,9851,0,71909
189,8240,6532,0,34,8206,1571544,9885,0,71909
190,8208,3872,2,20,8188,1575880,9905,0,71907
191,8189,3482,1,18,8171,1580587,9923,0,71906
192,8172,2737,1,14,8158,1586022,9937,0,71905
193,8158,3948,0,20,8138,1590232,9957,0,71905
194,8138,3166,0,16,8122,1595204,9973,0,71905
195,8122,2973,0,15,8107,1600353,9988,0,71905
196,8107,3356,0,17,8090,1605104,10005,0,71905
197,8090,3019,0,15,8075,1610175,10020,0,71905
198,8075,5550,0,28,8047,1612700,10048,0,71905
199,8048,6312,1,32,8016,1614436,10080,0,71904
200,8016,5130,0,26,7990,1617322,10106,0,71904
201,7990,7407,0,36,7954,1617905,10142,0,71904
202,7955,6180,1,30,7925,1619680,10172,0,71903
203,7926,4011,1,20,7906,1623595,10192,0,71902
204,7906,6266,0,30,7876,1625235,10222,0,71902
205,7879,5629,3,27,7852,1627485,10249,0,71899
206,7854,6718,2,33,7821,1628621,10282,0,71897
207,7822,4433,1,21,7801,1632010,10303,0,71896
208,7802,2765,1,13,7789,1637047,10316,0,71895
209,7789,5510,0,26,7763,1639326,10342,0,71895
210,7767,3498,4,17,7750,1643595,10359,0,71891
211,7751,2603,1,12,7739,1648743,10371,0,71890
212,7741,3444,2,16,7725,1653040,10386,0,71889
213,7726,3029,1,14,7712,1657737,10400,0,71888
214,7712,5906,0,27,7685,1659543,10427,0,71888
215,7685,9153,0,42,7643,1658075,10469,0,71888
216,7644,2422,1,11,7633,1663297,10480,0,71887
217,7633,5092,0,23,7610,1665838,10503,0,71887
218,7610,1119,0,5,7605,1672329,10508,0,71887
219,7605,1337,0,6,7599,1678597,10514,0,71887
220,7601,4017,2,18,7583,1682181,10531,0,71886
221,7583,8991,0,40,7543,1680773,10571,0,71886
222,7544,4745,1,21,7523,1683572,10592,0,71885
223,7524,6586,1,30,7494,1684510,10622,0,71884
224,7495,6393,1,28,7467,1685612,10650,0,71883
225,7469,2964,2,13,7456,1690117,10663,0,71881
226,7457,3332,1,15,7442,1694242,10678,0,71880
227,7448,4142,6,18,7430,1697548,10696,0,71874
228,7431,4853,1,21,7410,1700126,10716,0,71874
229,7412,2336,2,10,7402,1705202,10725,0,71873
230,7402,2873,0,13,7389,1709731,10738,0,71873
231,7389,4227,0,18,7371,1712893,10756,0,71873
232,7371,233,0,1,7370,1720031,10757,0,71873
233,7372,4267,2,18,7354,1723136,10775,0,71871
234,7357,1905,3,8,7349,1728588,10783,0,71868
235,7349,9351,0,39,7310,1726586,10822,0,71868
236,7310,5278,0,22,7288,1728618,10844,0,71868
237,7289,4573,1,19,7270,1731334,10863,0,71867
238,7271,5087,1,22,7249,1733518,10885,0,71866
239,7249,1687,0,7,7242,1739080,10892,0,71866
240,7243,6822,1,28,7215,1739501,10919,0,71866
241,7216,4902,1,20,7196,1741815,10939,0,71865
242,7198,3441,2,14,7184,1745572,10953,0,71863
243,7184,2455,0,10,7174,1750301,10963,0,71863
244,7175,10473,1,43,7132,1747003,11006,0,71862
245,7132,4963,0,20,7112,1749172,11026,0,71862
246,7113,3261,1,13,7100,1753024,11039,0,71861
247,7101,8043,1,32,7069,1752082,11071,0,71860
248,7070,2535,1,10,7060,1756617,11081,0,71859
249,7062,8608,2,34,7028,1755071,11115,0,71857
250,7030,6861,2,29,7001,1755240,11144,0,71855
251,7002,2285,1,9,6993,1759957,11153,0,71854
252,6993,6384,0,25,6968,1760566,11178,0,71854
253,6969,6672,1,26,6943,1760863,11203,0,71854
254,6943,3096,0,12,6931,1764710,11215,0,71854
255,6932,6528,1,26,6906,1765114,11240,0,71854
256,6908,2627,2,10,6898,1769395,11250,0,71852
257,6900,7822,2,30,6870,1768473,11280,0,71850
258,6871,3163,1,12,6859,1772181,11292,0,71849
259,6859,3960,0,15,6844,1775080,11307,0,71849
260,6847,4391,3,17,6830,1777536,11323,0,71847
261,6830,5684,0,22,6808,1778682,11345,0,71847
262,6809,3524,1,14,6795,1781967,11358,0,71847
263,6796,5872,1,22,6774,1782891,11380,0,71846
264,6774,7255,0,27,6747,1782410,11407,0,71846
265,6747,5124,0,19,6728,1784033,11426,0,71846
266,6729,8124,1,30,6699,1782638,11456,0,71845
267,6699,5698,0,21,6678,1783639,11477,0,71845
268,6678,2178,0,8,6670,1788139,11485,0,71845
269,6673,1360,3,5,6668,1793452,11490,0,71842
270,6668,5603,0,21,6647,1794517,11511,0,71842
271,6650,2468,3,9,6641,1798699,11520,0,71839
272,6644,3034,3,11,6633,1802309,11531,0,71836
273,6634,1936,1,7,6627,1807007,11538,0,71835
274,6630,2232,3,8,6622,1811405,11546,0,71832
275,6622,560,0,2,6620,1817467,11548,0,71832
276,6620,4757,0,17,6603,1819330,11565,0,71832
277,6603,6493,0,23,6580,1819440,11588,0,71832
278,6582,11852,2,43,6539,1814170,11630,0,71831
279,6539,9747,0,36,6503,1810962,11666,0,71831
280,6505,6516,2,23,6482,1810951,11688,0,71830
281,6482,5127,0,18,6464,1812306,11706,0,71830
282,6466,4874,2,17,6449,1813898,11723,0,71828
283,6451,4873,2,17,6434,1815476,11740,0,71826
284,6435,6606,1,23,6412,1815305,11762,0,71826
285,6412,2604,0,9,6403,1819113,11771,0,71826
286,6404,9767,1,35,6369,1815750,11806,0,71825
287,6370,5258,1,18,6352,1816862,11823,0,71825
288,6353,5485,1,19,6334,1817730,11842,0,71824
289,6334,8201,0,28,6306,1815863,11870,0,71824
290,6306,10599,0,36,6270,1811570,11906,0,71824
291,6270,4127,0,14,6256,1813713,11920,0,71824
292,6256,6212,0,22,6234,1813757,11942,0,71824
293,6235,4243,1,15,6220,1815749,11957,0,71823
294,6220,4495,0,15,6205,1817474,11972,0,71823
295,6207,1201,2,4,6203,1822480,11976,0,71821
296,6203,1829,0,6,6197,1826854,11982,0,71821
297,6199,6606,2,22,6177,1826447,12004,0,71819
298,6177,4525,0,15,6162,1828099,12019,0,71819
299,6164,9719,2,33,6131,1824544,12052,0,71817
300,6131,2740,0,9,6122,1827935,12061,0,71817
301,6122,5773,0,19,6103,1828284,12080,0,71817
302,6103,1529,0,5,6098,1832858,12085,0,71817
303,6098,14102,0,46,6052,1824854,12131,0,71817
304,6053,3086,1,10,6043,1827821,12141,0,71816
305,6044,13405,1,44,6000,1820460,12185,0,71815
306,6001,7129,1,23,5978,1819332,12208,0,71814
307,5979,4344,1,14,5965,1820967,12221,0,71814
308,5966,5593,1,18,5948,1821340,12239,0,71813
309,5949,5943,1,19,5930,1821346,12258,0,71812
310,5931,311,1,1,5930,1826966,12259,0,71811
311,5930,8564,0,28,5902,1824332,12287,0,71811
312,5903,3806,1,12,5891,1826429,12298,0,71811
313,5892,6899,1,22,5870,1825422,12320,0,71810
314,5870,6684,0,21,5849,1824608,12341,0,71810
315,5850,4783,1,15,5835,1825675,12356,0,71809
316,5836,3520,1,11,5825,1827991,12367,0,71808
317,5825,5127,0,16,5809,1828689,12383,0,71808
318,5810,5473,1,17,5793,1829026,12400,0,71807
319,5793,3217,0,10,5783,1831602,12410,0,71807
320,5784,3556,1,11,5773,1833830,12421,0,71806
321,5773,9182,0,29,5744,1830421,12450,0,71806
322,5744,5902,0,19,5725,1830263,12469,0,71806
323,5725,10132,0,31,5694,1825856,12500,0,71806
324,5694,1965,0,6,5688,1829585,12506,0,71806
325,5689,2987,1,9,5680,1832287,12515,0,71805
326,5680,3315,0,10,5670,1834652,12525,0,71805
327,5670,2353,0,8,5662,1837969,12533,0,71805
328,5663,1995,1,6,5657,1841637,12539,0,71804
329,5657,1356,0,5,5652,1845938,12544,0,71804
330,5654,4670,2,14,5640,1846922,12557,0,71803
331,5640,4671,0,14,5626,1847891,12571,0,71803
332,5627,4249,1,13,5614,1849269,12584,0,71802
333,5614,2379,0,7,5607,1852504,12591,0,71802
334,5608,3944,1,12,5596,1854168,12603,0,71801
335,5598,6796,2,20,5578,1852970,12623,0,71799
336,5581,10365,3,31,5550,1848186,12654,0,71796
337,5551,3419,1,10,5541,1850318,12664,0,71795
338,5542,2485,1,8,5534,1853375,12672,0,71794
339,5534,6513,0,19,5515,1852396,12691,0,71794
340,5515,2062,0,6,5509,1855849,12697,0,71794
341,5509,5825,0,17,5492,1855533,12714,0,71794
342,5492,1384,0,4,5488,1859641,12718,0,71794
343,5488,9710,0,28,5460,1855419,12746,0,71794
344,5463,3947,3,12,5451,1856935,12758,0,71791
345,5452,2786,1,8,5444,1859601,12766,0,71790
346,5444,11114,0,32,5412,1853931,12798,0,71790
347,5415,7357,3,21,5394,1851989,12819,0,71787
348,5395,4483,1,14,5381,1852901,12833,0,71786
349,5382,4231,1,12,5370,1854052,12845,0,71785
350,5372,1427,2,4,5368,1857997,12849,0,71783
351,5370,4577,2,14,5356,1858790,12862,0,71782
352,5357,1785,1,5,5352,1862362,12867,0,71781
353,5352,3932,0,11,5341,1863782,12878,0,71781
354,5342,2690,1,8,5334,1866434,12886,0,71780
355,5334,6807,0,19,5315,1864961,12905,0,71780
356,5316,1442,1,4,5312,1868835,12909,0,71779
357,5313,7905,1,22,5291,1866243,12931,0,71778
358,5292,4720,1,13,5279,1866815,12943,0,71778
359,5280,1086,1,3,5277,1871009,12946,0,71777
360,5277,723,0,2,5275,1875563,12948,0,71777
361,5275,6929,0,19,5256,1873909,12967,0,71777
362,5257,4601,1,13,5244,1874565,12980,0,71776
363,5245,4060,1,11,5234,1875750,12991,0,71775
364,5237,2586,3,7,5230,1878401,12998,0,71772
365,5230,5874,0,16,5214,1877757,13014,0,71772
366,5217,4067,3,12,5205,1878907,13025,0,71770
367,5207,954,2,3,5204,1883160,13028,0,71768
368,5206,4830,2,13,5193,1883536,13041,0,71766
369,5194,5921,1,16,5178,1882809,13057,0,71765
370,5179,2180,1,6,5173,1885808,13063,0,71764
371,5174,7238,1,20,5154,1883744,13083,0,71763
372,5155,1501,1,4,5151,1887398,13087,0,71762
373,5151,1890,0,5,5146,1890659,13092,0,71762
374,5146,1889,0,5,5141,1893916,13097,0,71762
375,5145,10103,4,27,5118,1888958,13123,0,71759
376,5118,3419,0,9,5109,1890657,13132,0,71759
377,5110,3430,1,9,5101,1892337,13141,0,71758
378,5102,1529,1,4,5098,1895910,13145,0,71757
379,5099,4962,1,13,5086,1896047,13158,0,71756
380,5086,5006,0,13,5073,1896127,13171,0,71756
381,5074,3482,1,9,5065,1897719,13180,0,71755
382,5067,13981,2,37,5030,1888805,13217,0,71753
383,5031,3860,1,10,5021,1889976,13227,0,71752
384,5021,5813,0,15,5006,1889184,13242,0,71752
385,5006,1957,0,5,5001,1892233,13247,0,71752
386,5001,2504,0,7,4994,1894730,13254,0,71752
387,4996,0,2,0,4996,1899726,13254,0,71750
388,5000,5784,4,15,4985,1898942,13269,0,71746
389,4985,1183,0,3,4982,1902744,13272,0,71746
390,4982,8281,0,21,4961,1899445,13293,0,71746
391,4962,1584,1,4,4958,1902823,13297,0,71745
392,4959,3557,1,9,4950,1904225,13306,0,71744
393,4951,5732,1,15,4936,1903444,13321,0,71743
394,4936,5170,0,13,4923,1903210,13334,0,71743
395,4924,10378,1,26,4898,1897756,13360,0,71742
396,4899,5192,1,14,4885,1897463,13374,0,71741
397,4885,2819,0,7,4878,1899529,13381,0,71741
398,4878,4815,0,12,4866,1899592,13393,0,71741
399,4868,7364,2,19,4849,1897096,13412,0,71739
400,4850,4855,1,12,4838,1897091,13424,0,71738
401,4838,3242,0,8,4830,1898687,13432,0,71738
402,4830,1216,0,3,4827,1902301,13435,0,71738
403,4828,1875,1,6,4822,1905254,13441,0,71737
404,4823,8984,1,22,4801,1901093,13463,0,71736
405,4802,6536,1,16,4786,1899359,13479,0,71735
406,4786,10883,0,27,4759,1893262,13506,0,71735
407,4759,1638,0,4,4755,1896383,13510,0,71735
408,4757,1651,2,4,4753,1899489,13514,0,71733
409,4753,2939,0,8,4745,1901303,13522,0,71733
410,4745,3871,0,10,4735,1902177,13532,0,71733
411,4736,10690,1,26,4710,1896223,13558,0,71732
412,4712,2904,2,7,4705,1898031,13564,0,71731
413,4705,5005,0,12,4693,1897731,13576,0,71731
414,4694,2095,1,5,4689,1900330,13581,0,71730
415,4689,9656,0,23,4666,1895363,13604,0,71730
416,4666,7069,0,17,4649,1892960,13621,0,71730
417,4650,2264,1,6,4644,1895346,13626,0,71730
418,4644,5955,0,15,4629,1894035,13641,0,71730
419,4631,8896,2,21,4610,1889770,13661,0,71729
420,4612,1699,2,4,4608,1892683,13665,0,71727
421,4608,3701,0,9,4599,1893590,13674,0,71727
422,4600,3026,1,8,4592,1895164,13681,0,71727
423,4592,6000,0,15,4577,1893756,13696,0,71727
424,4579,5149,2,12,4567,1893186,13708,0,71725
425,4567,3125,0,8,4559,1894628,13716,0,71725
426,4560,2581,1,6,4554,1896607,13722,0,71724
427,4555,2893,1,7,4548,1898269,13729,0,71723
428,4548,9097,0,22,4526,1893720,13751,0,71723
429,4527,1739,1,4,4523,1896508,13754,0,71723
430,4524,1735,1,4,4520,1899297,13758,0,71722
431,4522,868,2,2,4520,1902951,13760,0,71720
432,4520,2622,0,6,4514,1904849,13766,0,71720
433,4515,2623,1,6,4509,1906741,13772,0,71719
434,4510,3292,1,8,4502,1907959,13780,0,71718
435,4502,2200,0,5,4497,1910261,13785,0,71718
436,4497,7660,0,18,4479,1907098,13803,0,71718
437,4480,5741,1,13,4467,1905837,13816,0,71717
438,4467,4672,0,11,4456,1905632,13827,0,71717
439,4457,5311,1,12,4445,1904778,13838,0,71717
440,4445,6684,0,15,4430,1902539,13853,0,71717
441,4430,9352,0,21,4409,1897617,13874,0,71717
442,4410,7274,1,17,4393,1894753,13891,0,71716
443,4394,5646,1,13,4381,1893501,13904,0,71715
444,4381,7218,0,17,4364,1890664,13921,0,71715
445,4365,4925,1,11,4354,1890104,13932,0,71714
446,4354,8288,0,19,4335,1886170,13951,0,71714
447,4335,2260,0,5,4330,1888245,13956,0,71714
448,4332,1811,2,4,4328,1890766,13960,0,71712
449,4328,5569,0,13,4315,1889525,13973,0,71712
450,4316,2781,1,7,4309,1891060,13980,0,71711
451,4309,4099,0,9,4300,1891270,13989,0,71711
452,4300,3376,0,8,4292,1892194,13997,0,71711
453,4292,3869,0,9,4283,1892617,14006,0,71711
454,4284,3198,1,7,4277,1893703,14013,0,71710
455,4281,2003,4,5,4276,1895981,14017,0,71707
456,4277,5508,1,12,4265,1894750,14029,0,71706
457,4265,1846,0,4,4261,1897169,14033,0,71706
458,4261,10171,0,22,4239,1891259,14055,0,71706
459,4239,6720,0,15,4224,1888778,14070,0,71706
460,4227,3714,3,8,4219,1889291,14078,0,71703
461,4219,1853,0,4,4215,1891657,14082,0,71703
462,4215,3249,0,7,4208,1892623,14089,0,71703
463,4208,6064,0,13,4195,1890767,14102,0,71703
464,4195,7010,0,15,4180,1887952,14117,0,71703
465,4181,3277,1,7,4174,1888856,14124,0,71702
466,4175,3362,1,8,4167,1889669,14132,0,71701
467,4168,953,1,2,4166,1892884,14134,0,71700
468,4166,3301,0,7,4159,1893749,14141,0,71700
469,4159,4517,0,10,4149,1893391,14151,0,71700
470,4150,1891,1,4,4146,1895650,14154,0,71700
471,4146,5770,0,13,4133,1894026,14167,0,71700
472,4135,2380,2,5,4130,1895781,14171,0,71699
473,4131,2856,1,6,4125,1897056,14177,0,71698
474,4126,6688,1,14,4112,1894494,14191,0,71697
475,4114,3840,2,8,4106,1894768,14198,0,71696
476,4108,1918,2,4,4104,1896958,14201,0,71695
477,4105,4315,1,9,4096,1896748,14210,0,71694
478,4097,966,1,2,4095,1899879,14212,0,71693
479,4095,5185,0,11,4084,1898789,14223,0,71693
480,4084,2411,0,5,4079,1900462,14228,0,71693
481,4079,3561,0,8,4071,1900980,14236,0,71693
482,4072,3429,1,7,4065,1901623,14243,0,71692
483,4065,11207,0,23,4042,1894481,14266,0,71692
484,4045,6839,3,14,4031,1891687,14280,0,71689
485,4031,7671,0,17,4014,1888047,14297,0,71689
486,4014,5866,0,12,4002,1886195,14309,0,71689
487,4004,8833,2,18,3986,1881366,14327,0,71687
488,3986,2237,0,6,3980,1883115,14333,0,71687
489,3981,2465,1,5,3976,1884631,14337,0,71687
490,3976,1495,0,3,3973,1887112,14340,0,71687
491,3974,3459,1,7,3967,1887627,14346,0,71687
492,3968,6489,1,14,3954,1885106,14360,0,71686
493,3954,1492,0,3,3951,1887568,14363,0,71686
494,3952,4063,1,9,3943,1887457,14372,0,71685
495,3946,2487,3,5,3941,1888916,14376,0,71683
496,3941,5007,0,10,3931,1887850,14386,0,71683
497,3931,8541,0,17,3914,1883240,14403,0,71683
498,3916,5003,2,10,3906,1882153,14413,0,71681
499,3906,3011,0,6,3900,1883048,14419,0,71681
500,3900,4046,0,8,3892,1882902,14427,0,71681
501,3893,1005,1,2,3891,1885790,14429,0,71680
502,3891,2017,0,4,3887,1887664,14433,0,71680
503,3887,2026,0,4,3883,1889525,14437,0,71680
504,3883,3049,0,6,3877,1890359,14443,0,71680
505,3878,5286,1,11,3867,1888951,14454,0,71679
506,3870,2553,3,5,3865,1890268,14459,0,71676
507,3865,7652,0,15,3850,1886481,14474,0,71676
508,3852,1535,2,3,3849,1888798,14477,0,71674
509,3849,6158,0,12,3837,1886489,14489,0,71674
510,3838,2566,1,5,3833,1887761,14494,0,71673
511,3834,3079,1,6,3828,1888516,14500,0,71672
512,3828,3617,0,7,3821,1888727,14507,0,71672
513,3822,520,1,1,3821,1892029,14508,0,71671
514,3822,2833,1,6,3816,1893018,14514,0,71670
515,3818,517,2,1,3817,1896319,14515,0,71668
516,3819,7562,2,15,3804,1892576,14530,0,71666
517,3806,6246,2,12,3794,1890136,14542,0,71664
518,3794,4553,0,9,3785,1889377,14551,0,71664
519,3787,5754,2,11,3776,1887410,14561,0,71663
520,3776,1046,0,2,3774,1890140,14563,0,71663
521,3776,4192,2,8,3768,1889724,14571,0,71661
522,3769,0,1,0,3769,1893493,14571,0,71660
523,3769,1049,0,2,3767,1896213,14573,0,71660
524,3768,2643,1,5,3763,1897338,14578,0,71659
525,3763,1403,0,3,3760,1899698,14581,0,71659
526,3760,5303,0,10,3750,1898155,14591,0,71659
527,3750,2120,0,4,3746,1899785,14595,0,71659
528,3747,6064,1,12,3735,1897468,14607,0,71658
529,3736,7458,1,14,3722,1893746,14621,0,71657
530,3722,2131,0,4,3718,1895337,14625,0,71657
531,3721,3215,3,6,3715,1895843,14631,0,71654
532,3715,1607,0,3,3712,1897951,14634,0,71654
533,3713,11844,1,22,3691,1889820,14656,0,71653
534,3693,4831,2,9,3684,1888682,14665,0,71651
535,3685,1079,1,2,3683,1891288,14667,0,71650
536,3683,2700,0,5,3678,1892271,14672,0,71650
537,3680,4323,2,8,3672,1891628,14680,0,71648
538,3673,7511,1,14,3659,1887790,14693,0,71648
539,3660,7764,1,15,3645,1883686,14708,0,71647
540,3646,2171,1,4,3642,1885161,14712,0,71646
541,3642,2175,0,4,3638,1886628,14716,0,71646
542,3639,2723,1,5,3634,1887544,14721,0,71645
543,3634,4913,0,9,3625,1886265,14730,0,71645
544,3626,9877,1,18,3608,1880014,14747,0,71645
545,3612,7150,4,13,3599,1876476,14760,0,71641
546,3599,5183,0,11,3588,1874892,14771,0,71641
547,3591,9357,3,17,3574,1869126,14787,0,71639
548,3574,2756,0,5,3569,1869944,14792,0,71639
549,3570,6733,1,13,3557,1866781,14805,0,71638
550,3558,2219,1,4,3554,1868120,14809,0,71637
551,3555,410,1,2,3553,1871265,14811,0,71636
552,3553,7781,0,14,3539,1867037,14825,0,71636
553,3540,5562,1,10,3530,1865015,14834,0,71636
554,3532,6280,2,12,3520,1862267,14845,0,71635
555,3521,6693,1,12,3509,1859095,14857,0,71634
556,3510,3575,1,7,3503,1859030,14864,0,71633
557,3504,5607,1,10,3494,1856927,14874,0,71632
558,3495,3377,1,6,3489,1857045,14880,0,71631
559,3492,4653,3,9,3483,1855884,14889,0,71628
560,3483,3582,0,7,3476,1855785,14896,0,71628
561,3478,575,2,1,3477,1858688,14897,0,71626
562,3479,1690,2,3,3476,1860477,14899,0,71625
563,3476,2267,0,4,3472,1861686,14903,0,71625
564,3472,1134,0,2,3470,1864024,14905,0,71625
565,3471,2844,1,5,3466,1864651,14909,0,71625
566,3466,5689,0,10,3456,1862428,14919,0,71625
567,3456,857,0,2,3454,1865027,14921,0,71625
568,3454,1490,0,3,3451,1866991,14924,0,71625
569,3452,1143,1,2,3450,1869300,14926,0,71624
570,3450,4202,0,8,3442,1868548,14934,0,71624
571,3442,4605,0,8,3434,1867385,14942,0,71624
572,3434,603,0,3,3431,1870216,14945,0,71624
573,3433,2310,2,4,3429,1871339,14948,0,71623
574,3429,3463,0,6,3423,1871305,14954,0,71623
575,3423,5788,0,10,3413,1868940,14964,0,71623
576,3415,6950,2,12,3403,1865405,14976,0,71621
577,3405,1161,2,2,3403,1867649,14978,0,71619
578,3403,0,0,0,3403,1871052,14978,0,71619
579,3404,581,1,1,3403,1873875,14979,0,71618
580,3404,583,1,1,3403,1876696,14979,0,71618
581,3403,0,0,0,3403,1880099,14979,0,71618
582,3403,1285,0,4,3399,1882217,14983,0,71618
583,3400,4482,1,8,3392,1881135,14991,0,71617
584,3393,1764,1,3,3390,1882764,14994,0,71616
585,3390,4147,0,7,3383,1882007,15001,0,71616
586,3383,3547,0,6,3377,1881843,15007,0,71616
587,3378,4560,1,8,3370,1880661,15015,0,71615
588,3371,1090,1,3,3368,1882942,15018,0,71614
589,3369,3103,1,6,3363,1883208,15024,0,71613
590,3364,2898,1,6,3358,1883674,15029,0,71613
591,3359,3576,1,6,3353,1883457,15035,0,71612
592,3354,3591,1,6,3348,1883220,15041,0,71611
593,3351,1788,3,3,3348,1884783,15042,0,71610
594,3351,5979,3,10,3341,1882155,15052,0,71607
595,3341,2689,0,5,3336,1882807,15057,0,71607
596,3336,3600,0,6,3330,1882543,15063,0,71607
597,3330,12586,0,21,3309,1873287,15084,0,71607
598,3309,2418,0,4,3305,1874178,15088,0,71607
599,3305,4588,0,8,3297,1872895,15096,0,71607
600,3298,3866,1,7,3291,1872327,15103,0,71606
601,3291,0,0,0,3291,1875618,15103,0,71606
602,3291,603,0,1,3290,1878306,15104,0,71606
603,3292,7268,2,12,3280,1874330,15116,0,71604
604,3282,3645,2,6,3276,1873967,15122,0,71602
605,3276,9959,0,17,3259,1867284,15139,0,71602
606,3259,1218,0,2,3257,1869325,15141,0,71602
607,3257,3052,0,5,3252,1869530,15146,0,71602
608,3253,5291,1,9,3244,1867492,15155,0,71601
609,3245,3076,1,5,3240,1867661,15160,0,71600
610,3240,2452,0,4,3236,1868449,15164,0,71600
611,3236,1266,0,3,3233,1870419,15167,0,71600
612,3233,2460,0,4,3229,1871192,15171,0,71600
613,3230,3080,1,5,3225,1871342,15176,0,71599
614,3225,618,0,1,3224,1873949,15177,0,71599
615,3225,619,1,1,3224,1876555,15178,0,71598
616,3225,3847,1,7,3218,1875933,15185,0,71597
617,3218,1252,0,2,3216,1877899,15187,0,71597
618,3217,3735,1,6,3211,1877381,15192,0,71597
619,3212,9831,1,16,3196,1870762,15208,0,71596
620,3196,1255,0,2,3194,1872703,15210,0,71596
621,3195,5630,1,9,3186,1870268,15219,0,71595
622,3186,7082,0,12,3174,1866372,15231,0,71595
623,3174,3761,0,7,3167,1865785,15238,0,71595
624,3168,1253,1,2,3166,1867700,15240,0,71594
625,3167,1257,1,2,3165,1869610,15242,0,71593
626,3166,1264,1,2,3164,1871512,15243,0,71593
627,3164,8828,0,14,3150,1865848,15257,0,71593
628,3150,1897,0,3,3147,1867101,15260,0,71593
629,3147,1262,0,2,3145,1868986,15262,0,71593
630,3145,3807,0,6,3139,1868324,15268,0,71593
631,3140,1901,1,3,3137,1869563,15271,0,71592
632,3137,5582,0,9,3128,1867118,15280,0,71592
633,3130,1272,2,2,3128,1868976,15282,0,71590
634,3128,5789,0,10,3118,1866315,15292,0,71590
635,3120,2555,2,4,3116,1866880,15296,0,71588
636,3116,4475,0,7,3109,1865521,15303,0,71588
637,3110,3285,1,6,3104,1865346,15309,0,71587
638,3104,2563,0,4,3100,1865887,15313,0,71587
639,3102,2255,2,4,3098,1866734,15317,0,71585
640,3099,5156,1,8,3091,1864677,15325,0,71584
641,3092,8416,1,13,3079,1859353,15338,0,71583
642,3080,216,1,1,3079,1862217,15339,0,71582
643,3079,773,0,2,3077,1864523,15341,0,71582
644,3077,3240,0,5,3072,1864360,15346,0,71582
645,3072,2591,0,4,3068,1864841,15350,0,71582
646,3070,5835,2,9,3061,1862076,15359,0,71580
647,3062,6527,1,10,3052,1858611,15369,0,71579
648,3052,2621,0,4,3048,1859042,15373,0,71579
649,3049,3912,1,6,3043,1858179,15379,0,71578
650,3044,6278,1,11,3033,1854945,15390,0,71577
651,3033,6235,0,12,3021,1851743,15402,0,71577
652,3022,1971,1,3,3019,1852794,15405,0,71576
653,3019,6470,0,10,3009,1849343,15415,0,71576
654,3010,1254,1,2,3008,1851099,15416,0,71576
655,3008,101,0,1,3007,1854006,15417,0,71576
656,3008,3964,1,6,3002,1853050,15423,0,71575
657,3004,4652,2,7,2997,1851402,15429,0,71574
658,2999,3145,2,5,2994,1851256,15434,0,71572
659,2995,4645,1,7,2988,1849606,15441,0,71571
660,2988,6546,0,10,2978,1846048,15451,0,71571
661,2979,1337,1,2,2977,1847690,15453,0,71570
662,2979,7336,2,11,2968,1843333,15464,0,71568
663,2969,790,1,2,2967,1845512,15465,0,71568
664,2968,2002,1,3,2965,1846478,15468,0,71567
665,2966,296,1,1,2965,1849148,15469,0,71566
666,2966,5351,1,8,2958,1846763,15477,0,71565
667,2958,1630,0,3,2955,1848091,15480,0,71565
668,2956,6036,1,9,2947,1845011,15488,0,71565
669,2947,0,0,0,2947,1847958,15488,0,71565
670,2947,673,0,1,2946,1850232,15489,0,71565
671,2947,4724,1,7,2940,1848455,15496,0,71564
672,2940,6081,0,9,2931,1845314,15505,0,71564
673,2931,6236,0,10,2921,1842009,15515,0,71564
674,2921,4736,0,7,2914,1840194,15522,0,71564
675,2916,2751,2,5,2911,1840359,15526,0,71563
676,2912,1149,1,2,2910,1842122,15527,0,71563
677,2910,2233,0,4,2906,1842799,15531,0,71563
678,2907,684,1,1,2906,1845022,15532,0,71562
679,2906,5458,0,8,2898,1842470,15540,0,71562
680,2900,4102,2,6,2894,1841268,15545,0,71561
681,2895,4096,1,6,2889,1840067,15551,0,71560
682,2891,4808,2,7,2884,1838150,15557,0,71559
683,2886,2059,2,3,2883,1838977,15560,0,71557
684,2883,4135,0,6,2877,1837725,15566,0,71557
685,2878,1373,1,2,2876,1839230,15568,0,71556
686,2877,6202,1,9,2868,1835905,15577,0,71555
687,2868,2065,0,3,2865,1836708,15580,0,71555
688,2866,7604,1,11,2855,1831970,15591,0,71554
689,2857,1388,2,2,2855,1833439,15593,0,71552
690,2858,2773,3,4,2854,1833524,15597,0,71549
691,2854,1426,0,3,2851,1834952,15600,0,71549
692,2852,2790,1,4,2848,1835014,15604,0,71548
693,2850,2953,2,5,2845,1834911,15609,0,71546
694,2845,2101,0,3,2842,1835655,15612,0,71546
695,2843,7861,1,12,2831,1830637,15624,0,71545
696,2831,4201,0,6,2825,1829267,15630,0,71545
697,2827,6304,2,9,2818,1825790,15639,0,71543
698,2819,2811,1,4,2815,1825798,15643,0,71542
699,2817,6042,2,10,2807,1822573,15653,0,71540
700,2807,1416,0,2,2805,1823964,15655,0,71540
701,2806,2567,1,4,2802,1824203,15659,0,71539
702,2803,4006,1,6,2797,1823000,15665,0,71538
703,2801,10722,4,16,2785,1815079,15680,0,71535
704,2786,714,1,1,2785,1817151,15681,0,71534
705,2786,712,1,1,2785,1819225,15682,0,71533
706,2787,1417,2,2,2785,1820595,15684,0,71531
707,2789,4268,4,6,2783,1819116,15690,0,71527
708,2784,1426,1,2,2782,1820474,15692,0,71526
709,2783,2120,1,3,2780,1821137,15695,0,71525
710,2780,1523,0,3,2777,1822394,15698,0,71525
711,2777,3579,0,5,2772,1821592,15703,0,71525
712,2775,2148,3,3,2772,1822219,15704,0,71524
713,2773,4293,1,6,2767,1820699,15710,0,71523
714,2767,2875,0,4,2763,1820591,15714,0,71523
715,2766,6457,3,9,2757,1816900,15722,0,71521
716,2757,718,0,1,2756,1818939,15723,0,71521
717,2758,2894,2,5,2753,1818803,15727,0,71520
718,2754,2891,1,4,2750,1818666,15731,0,71519
719,2750,2166,0,3,2747,1819250,15734,0,71519
720,2747,2891,0,4,2743,1819106,15738,0,71519
721,2746,0,3,0,2746,1821852,15737,0,71517
722,2746,2910,0,4,2742,1821688,15741,0,71517
723,2742,2927,0,4,2738,1821503,15745,0,71517
724,2740,726,2,1,2739,1823517,15745,0,71516
725,2739,7284,0,10,2729,1818972,15755,0,71516
726,2730,1457,1,2,2728,1820245,15757,0,71515
727,2730,1087,2,2,2728,1821888,15759,0,71513
728,2728,3652,0,5,2723,1820964,15764,0,71513
729,2724,1466,1,2,2722,1822222,15766,0,71512
730,2722,735,0,1,2721,1824209,15767,0,71512
731,2721,4418,0,6,2715,1822512,15773,0,71512
732,2715,735,0,1,2714,1824492,15774,0,71512
733,2716,0,2,0,2716,1827208,15773,0,71511
734,2718,2215,2,3,2715,1827711,15775,0,71510
735,2715,2961,0,4,2711,1827465,15779,0,71510
736,2715,0,4,0,2715,1830180,15779,0,71506
737,2716,2977,1,4,2712,1829919,15782,0,71506
738,2714,0,2,0,2714,1832633,15782,0,71504
739,2715,3822,1,6,2709,1831526,15788,0,71503
740,2709,2975,0,4,2705,1831260,15792,0,71503
741,2707,3022,2,5,2702,1830945,15797,0,71501
742,2703,1494,1,2,2701,1832154,15799,0,71500
743,2701,1498,0,2,2699,1833357,15801,0,71500
744,2701,3635,2,5,2696,1832423,15806,0,71498
745,2697,2355,1,4,2693,1832765,15810,0,71497
746,2693,1120,0,2,2691,1834338,15812,0,71497
747,2694,3351,3,6,2688,1833681,15818,0,71494
748,2688,0,0,0,2688,1836369,15818,0,71494
749,2689,752,1,1,2688,1838306,15819,0,71493
750,2689,1756,1,3,2686,1839239,15822,0,71492
751,2687,3783,1,5,2682,1838143,15827,0,71491
752,2683,753,1,1,2682,1840073,15828,0,71490
753,2683,757,1,1,2682,1841999,15829,0,71489
754,2683,757,1,1,2682,1843925,15830,0,71488
755,2684,0,2,0,2684,1846609,15829,0,71487
756,2684,6078,0,8,2676,1843215,15837,0,71487
757,2677,763,1,1,2676,1845129,15838,0,71486
758,2677,1291,1,2,2675,1846515,15840,0,71485
759,2676,762,1,1,2675,1848429,15841,0,71484
760,2675,0,0,0,2675,1851104,15841,0,71484
761,2676,1529,1,2,2674,1852251,15843,0,71483
762,2675,801,1,2,2673,1854125,15845,0,71482
763,2673,3064,0,4,2669,1853734,15849,0,71482
764,2670,5376,1,7,2663,1851028,15856,0,71481
765,2663,5386,0,7,2656,1848305,15863,0,71481
766,2657,2315,1,3,2654,1848647,15866,0,71480
767,2655,3846,1,5,2650,1847456,15871,0,71479
768,2650,3082,0,4,2646,1847024,15875,0,71479
769,2648,4233,2,6,2642,1845439,15880,0,71478
770,2643,8869,1,12,2631,1839213,15892,0,71477
771,2631,4492,0,6,2625,1837352,15898,0,71477
772,2625,5085,0,8,2617,1834892,15906,0,71477
773,2617,1182,0,2,2615,1836327,15908,0,71477
774,2618,2719,3,5,2613,1836226,15913,0,71474
775,2615,1779,2,3,2612,1837062,15916,0,71472
776,2613,1557,1,2,2611,1838118,15918,0,71471
777,2612,4638,1,8,2604,1836092,15926,0,71470
778,2605,4609,1,7,2598,1834088,15932,0,71470
779,2599,332,1,1,2598,1836355,15933,0,71469
780,2599,3879,1,6,2593,1835075,15939,0,71468
781,2593,1617,0,3,2590,1836051,15942,0,71468
782,2592,7735,2,10,2582,1830908,15952,0,71466
783,2582,784,0,1,2581,1832706,15953,0,71466
784,2584,1572,3,3,2581,1833718,15955,0,71464
785,2581,2362,0,3,2578,1833937,15958,0,71464
786,2579,3168,1,4,2575,1833348,15962,0,71463
787,2575,2911,0,4,2571,1833012,15966,0,71463
788,2571,0,0,0,2571,1835583,15966,0,71463
789,2573,3182,2,4,2569,1834974,15970,0,71461
790,2570,498,1,2,2568,1837046,15972,0,71460
791,2568,4540,0,6,2562,1835074,15978,0,71460
792,2562,1962,0,3,2559,1835674,15981,0,71460
793,2559,2390,0,3,2556,1835843,15984,0,71460
794,2558,4777,2,6,2552,1833624,15990,0,71458
795,2553,4001,1,5,2548,1832176,15995,0,71457
796,2548,1227,0,2,2546,1833497,15997,0,71457
797,2546,2406,0,3,2543,1833637,16000,0,71457
798,2547,2846,4,4,2543,1833338,16004,0,71453
799,2543,3668,0,6,2537,1832213,16010,0,71453
800,2538,4355,1,7,2531,1830396,16017,0,71452
801,2531,4019,0,5,2526,1828908,16022,0,71452
802,2528,5640,2,7,2521,1825796,16029,0,71450
803,2523,0,2,0,2523,1828319,16028,0,71449
804,2524,1611,1,2,2522,1829232,16030,0,71448
805,2523,3231,1,4,2519,1828524,16034,0,71447
806,2520,2550,1,4,2516,1828494,16037,0,71447
807,2516,808,0,1,2515,1830202,16038,0,71447
808,2519,1621,4,2,2517,1831100,16039,0,71444
809,2518,3577,1,5,2513,1830041,16044,0,71443
810,2515,1624,2,2,2513,1830932,16046,0,71441
811,2515,3961,2,5,2510,1829486,16051,0,71439
812,2510,3261,0,4,2506,1828735,16055,0,71439
813,2509,2481,3,4,2505,1828763,16057,0,71438
814,2505,822,0,1,2504,1830446,16058,0,71438
815,2507,1804,3,3,2504,1831149,16059,0,71437
816,2505,4397,1,6,2499,1829257,16065,0,71436
817,2499,4924,0,6,2493,1826832,16071,0,71436
818,2494,564,1,1,2493,1828762,16072,0,71435
819,2495,3291,2,4,2491,1827966,16075,0,71434
820,2492,821,1,1,2491,1829637,16075,0,71434
821,2492,1083,1,2,2490,1831046,16077,0,71433
822,2490,825,0,1,2489,1832711,16078,0,71433
823,2490,2479,1,4,2486,1832722,16082,0,71432
824,2489,7440,3,9,2480,1827771,16091,0,71429
825,2481,1657,1,2,2479,1828595,16093,0,71428
826,2482,1931,3,3,2479,1829146,16095,0,71426
827,2479,0,0,0,2479,1831625,16095,0,71426
828,2480,4470,1,7,2473,1829635,16102,0,71425
829,2473,2634,0,4,2469,1829474,16106,0,71425
830,2469,5405,0,8,2461,1826538,16114,0,71425
831,2462,5741,1,7,2455,1823259,16121,0,71424
832,2456,1081,1,2,2454,1824634,16122,0,71424
833,2455,3349,1,4,2451,1823740,16125,0,71424
834,2451,2803,0,4,2447,1823388,16129,0,71424
835,2447,930,0,2,2445,1824905,16131,0,71424
836,2445,4230,0,6,2439,1823120,16137,0,71424
837,2440,1767,1,3,2437,1823793,16140,0,71423
838,2439,2527,2,3,2436,1823705,16143,0,71421
839,2437,9273,1,11,2426,1816869,16154,0,71420
840,2427,1704,1,2,2425,1817592,16155,0,71420
841,2425,0,0,0,2425,1820017,16155,0,71420
842,2427,0,2,0,2427,1822444,16155,0,71418
843,2429,1693,2,2,2427,1823180,16157,0,71416
844,2428,1692,1,2,2426,1823916,16159,0,71415
845,2427,8488,1,10,2417,1817855,16169,0,71414
846,2417,1695,0,2,2415,1818577,16171,0,71414
847,2417,949,2,2,2415,1820045,16172,0,71413
848,2415,4510,0,7,2408,1817950,16179,0,71413
849,2408,4335,0,6,2402,1816023,16185,0,71413
850,2403,0,1,0,2403,1818426,16185,0,71412
851,2405,78,2,1,2404,1820753,16186,0,71410
852,2405,1450,1,2,2403,1821708,16188,0,71409
853,2404,0,1,0,2404,1824112,16188,0,71408
854,2404,1721,0,2,2402,1824795,16190,0,71408
855,2402,5203,0,7,2395,1821994,16197,0,71408
856,2396,5277,1,7,2389,1819113,16204,0,71407
857,2390,1718,1,2,2388,1819785,16206,0,71406
858,2390,2029,2,3,2387,1820146,16208,0,71405
859,2388,3965,1,5,2383,1818569,16213,0,71404
860,2384,863,1,1,2383,1820090,16214,0,71403
861,2384,3112,1,4,2380,1819362,16218,0,71402
862,2384,1734,4,2,2382,1820012,16220,0,71398
863,2382,4771,0,7,2375,1817623,16227,0,71398
864,2375,1735,0,2,2373,1818263,16229,0,71398
865,2373,6956,0,8,2365,1813680,16237,0,71398
866,2367,879,2,2,2365,1815168,16239,0,71396
867,2367,1881,2,3,2364,1815654,16241,0,71395
868,2366,1747,2,2,2364,1816273,16243,0,71393
869,2364,3488,0,4,2360,1815149,16247,0,71393
870,2361,873,1,1,2360,1816637,16248,0,71392
871,2364,1753,4,2,2362,1817248,16249,0,71389
872,2363,54,1,1,2362,1819557,16250,0,71388
873,2364,4390,2,5,2359,1817531,16255,0,71386
874,2360,0,1,0,2360,1819891,16255,0,71385
875,2361,3713,1,5,2356,1818539,16259,0,71385
876,2357,1761,1,2,2355,1819135,16260,0,71385
877,2355,1759,0,2,2353,1819731,16262,0,71385
878,2353,5296,0,6,2347,1816788,16268,0,71385
879,2347,1772,0,2,2345,1817363,16270,0,71385
880,2348,2648,3,3,2345,1817063,16272,0,71383
881,2346,2406,1,3,2343,1817003,16274,0,71383
882,2346,5603,3,7,2339,1813746,16280,0,71381
883,2340,2757,1,4,2336,1813329,16283,0,71381
884,2336,3558,0,4,2332,1812107,16287,0,71381
885,2335,116,3,1,2334,1814326,16287,0,71379
886,2335,1790,1,2,2333,1814871,16289,0,71378
887,2334,4004,1,5,2329,1813201,16293,0,71378
888,2330,2124,1,3,2327,1813407,16296,0,71377
889,2327,2571,0,3,2324,1813163,16299,0,71377
890,2324,981,0,2,2322,1814506,16301,0,71377
891,2322,3583,0,4,2318,1813245,16305,0,71377
892,2319,2703,1,3,2316,1812861,16308,0,71376
893,2318,9331,2,11,2307,1805848,16319,0,71374
894,2308,1790,1,2,2306,1806366,16321,0,71373
895,2306,896,0,1,2305,1807776,16322,0,71373
896,2307,5406,2,6,2301,1804677,16328,0,71371
897,2301,4837,0,6,2295,1802141,16334,0,71371
898,2296,2741,1,4,2292,1801696,16338,0,71370
899,2293,5413,1,6,2287,1798576,16344,0,71369
900,2287,3879,0,6,2281,1796984,16350,0,71369
901,2281,6026,0,7,2274,1793239,16357,0,71369
902,2275,913,1,1,2274,1794601,16357,0,71369
903,2274,913,0,1,2273,1795962,16358,0,71369
904,2273,4077,0,5,2268,1794158,16363,0,71369
905,2269,5699,1,7,2262,1790728,16370,0,71368
906,2263,915,1,1,2262,1792076,16371,0,71367
907,2262,912,0,1,2261,1793426,16372,0,71367
908,2261,915,0,1,2260,1794772,16373,0,71367
909,2260,914,0,1,2259,1796118,16374,0,71367
910,2259,1823,0,2,2257,1796554,16376,0,71367
911,2258,4307,1,5,2253,1794505,16381,0,71366
912,2253,5157,0,7,2246,1791601,16388,0,71366
913,2246,3843,0,6,2240,1790004,16394,0,71366
914,2240,2754,0,3,2237,1789490,16397,0,71366
915,2237,916,0,1,2236,1790811,16398,0,71366
916,2236,2756,0,3,2233,1790291,16401,0,71366
917,2233,1838,0,2,2231,1790686,16403,0,71366
918,2233,924,2,1,2232,1791995,16404,0,71364
919,2234,1514,2,3,2231,1792715,16407,0,71362
920,2233,4898,2,6,2227,1790050,16412,0,71361
921,2228,11,1,1,2227,1792267,16413,0,71360
922,2227,925,0,1,2226,1793569,16414,0,71360
923,2228,0,2,0,2228,1795797,16414,0,71358
924,2229,1856,1,2,2227,1796170,16416,0,71357
925,2227,2784,0,3,2224,1795613,16419,0,71357
926,2225,8988,1,10,2215,1788850,16429,0,71356
927,2215,0,0,0,2215,1791065,16429,0,71356
928,2216,1670,1,2,2214,1791611,16431,0,71355
929,2215,1871,1,2,2213,1791955,16432,0,71355
930,2214,933,1,1,2213,1793236,16433,0,71354
931,2213,0,0,0,2213,1795449,16433,0,71354
932,2214,1876,1,2,2212,1795787,16435,0,71353
933,2212,950,0,2,2210,1797049,16437,0,71353
934,2211,0,1,0,2211,1799260,16437,0,71352
935,2211,2242,0,5,2206,1799229,16442,0,71352
936,2207,1882,1,2,2205,1799554,16444,0,71351
937,2206,1881,1,2,2204,1799879,16446,0,71350
938,2204,2829,0,3,2201,1799254,16449,0,71350
939,2201,1884,0,2,2199,1799571,16451,0,71350
940,2199,1884,0,2,2197,1799886,16453,0,71350
941,2198,4726,1,5,2193,1797358,16457,0,71350
942,2194,944,1,1,2193,1798608,16458,0,71349
943,2193,2835,0,3,2190,1797966,16461,0,71349
944,2191,2042,1,4,2187,1798115,16465,0,71348
945,2191,1896,4,2,2189,1798410,16466,0,71345
946,2189,525,0,1,2188,1800074,16467,0,71345
947,2190,2863,2,3,2187,1799401,16470,0,71343
948,2187,2466,0,4,2183,1799122,16474,0,71343
949,2184,7819,1,9,2175,1793487,16483,0,71342
950,2177,2982,2,4,2173,1792682,16487,0,71340
951,2174,5880,1,8,2166,1788976,16495,0,71339
952,2168,959,2,1,2167,1790185,16495,0,71338
953,2167,1155,0,2,2165,1791197,16497,0,71338
954,2168,0,3,0,2168,1793365,16495,0,71337
955,2169,962,1,1,2168,1794572,16495,0,71337
956,2169,2877,1,3,2166,1793864,16498,0,71336
957,2166,1921,0,2,2164,1794109,16500,0,71336
958,2165,1045,1,2,2163,1795229,16502,0,71335
959,2163,2346,0,5,2158,1795046,16507,0,71335
960,2158,7459,0,9,2149,1789745,16516,0,71335
961,2149,966,0,1,2148,1790928,16517,0,71335
962,2149,1927,1,2,2147,1791150,16519,0,71334
963,2147,259,0,1,2146,1793038,16520,0,71334
964,2146,2916,0,3,2143,1792268,16523,0,71334
965,2144,1192,1,2,2142,1793220,16525,0,71333
966,2144,2069,2,4,2140,1793295,16529,0,71331
967,2141,1943,1,2,2139,1793493,16531,0,71330
968,2139,6852,0,8,2131,1788780,16539,0,71330
969,2133,972,2,1,2132,1789941,16539,0,71329
970,2133,6331,1,7,2126,1785743,16545,0,71329
971,2128,2935,2,3,2125,1784936,16548,0,71327
972,2126,2139,1,4,2122,1784923,16551,0,71327
973,2122,1954,0,2,2120,1785091,16553,0,71327
974,2121,3906,1,4,2117,1783306,16556,0,71327
975,2118,1288,1,2,2116,1784136,16558,0,71326
976,2118,1254,2,3,2115,1785000,16561,0,71324
977,2117,981,2,1,2116,1786136,16561,0,71323
978,2117,1959,1,2,2115,1786294,16563,0,71322
979,2116,3309,1,4,2112,1785101,16567,0,71321
980,2113,0,1,0,2113,1787214,16567,0,71320
981,2114,3870,1,5,2109,1785458,16572,0,71319
982,2109,984,0,1,2108,1786583,16573,0,71319
983,2109,240,1,1,2108,1788452,16573,0,71319
984,2109,2732,1,4,2105,1787829,16577,0,71318
985,2105,3950,0,4,2101,1785984,16581,0,71318
986,2102,3709,1,4,2098,1784377,16585,0,71317
987,2099,1978,1,2,2097,1784498,16587,0,71316
988,2098,0,1,0,2098,1786596,16586,0,71316
989,2099,67,1,1,2098,1788628,16587,0,71315
990,2101,0,3,0,2101,1790729,16587,0,71312
991,2102,6571,1,7,2095,1786260,16594,0,71311
992,2095,1995,0,2,2093,1786360,16596,0,71311
993,2093,6065,0,8,2085,1782388,16604,0,71311
994,2085,3758,0,5,2080,1780715,16609,0,71311
995,2082,3992,2,4,2078,1778805,16613,0,71309
996,2078,10981,0,14,2064,1769902,16627,0,71309
997,2064,1854,0,3,2061,1770112,16630,0,71309
998,2062,2002,1,2,2060,1770172,16632,0,71308
999,2061,0,1,0,2061,1772233,16632,0,71307
1000,2062,1151,1,3,2059,1773144,16634,0,71307
1001,2061,0,2,0,2061,1775205,16633,0,71306
1002,2061,4017,0,4,2057,1773249,16637,0,71306
1003,2058,2015,1,2,2056,1773292,16639,0,71305
1004,2058,2032,2,2,2056,1773318,16641,0,71303
1005,2057,5740,1,6,2051,1769635,16647,0,71302
1006,2053,0,2,0,2053,1771688,16647,0,71300
1007,2054,3392,1,4,2050,1770350,16651,0,71299
1008,2052,1011,2,1,2051,1771391,16652,0,71297
1009,2054,297,3,1,2053,1773148,16652,0,71295
1010,2053,6143,0,7,2046,1769058,16659,0,71295
1011,2047,1015,1,1,2046,1770090,16660,0,71294
1012,2048,376,2,1,2047,1771762,16660,0,71293
1013,2048,4068,1,4,2044,1769742,16664,0,71292
1014,2044,3588,0,4,2040,1768198,16668,0,71292
1015,2040,1398,0,2,2038,1768840,16670,0,71292
1016,2040,1020,2,1,2039,1769860,16671,0,71290
1017,2039,464,0,1,2038,1771435,16672,0,71290
1018,2038,2790,0,4,2034,1770683,16676,0,71290
1019,2035,1022,1,1,2034,1771696,16677,0,71289
1020,2034,2049,0,2,2032,1771681,16679,0,71289
1021,2032,2055,0,2,2030,1771658,16681,0,71289
1022,2030,3085,0,3,2027,1770603,16684,0,71289
1023,2028,3814,1,6,2022,1768817,16690,0,71288
1024,2023,4225,1,5,2018,1766615,16695,0,71287
1025,2019,1286,1,2,2017,1767348,16696,0,71287
1026,2017,482,0,1,2016,1768883,16697,0,71287
1027,2017,5816,1,7,2010,1765084,16703,0,71287
1028,2011,1029,1,1,2010,1766066,16704,0,71286
1029,2012,3098,2,3,2009,1764980,16707,0,71284
1030,2010,5407,1,6,2004,1761583,16712,0,71284
1031,2005,9111,1,11,1994,1754477,16723,0,71283
1032,1995,0,1,0,1995,1756472,16723,0,71282
1033,1996,0,1,0,1996,1758468,16723,0,71281
1034,1998,3111,2,3,1995,1757355,16726,0,71279
1035,1996,3280,1,4,1992,1756071,16729,0,71279
1036,1992,419,0,1,1991,1757644,16730,0,71279
1037,1991,2288,0,3,1988,1757347,16733,0,71279
1038,1988,1042,0,1,1987,1758293,16734,0,71279
1039,1987,2120,0,3,1984,1758160,16737,0,71279
1040,1984,1042,0,1,1983,1759102,16738,0,71279
1041,1984,3657,1,4,1980,1757429,16742,0,71278
1042,1982,1959,2,2,1980,1757452,16744,0,71276
1043,1981,1328,1,2,1979,1758105,16746,0,71275
1044,1980,3376,1,4,1976,1756709,16750,0,71274
1045,1976,4456,0,6,1970,1754229,16756,0,71274
1046,1971,0,1,0,1971,1756200,16756,0,71273
1047,1971,3158,0,3,1968,1755013,16759,0,71273
1048,1968,3152,0,3,1965,1753829,16762,0,71273
1049,1965,0,0,0,1965,1755794,16762,0,71273
1050,1966,2086,1,2,1964,1755674,16764,0,71272
1051,1964,5589,0,7,1957,1752049,16771,0,71272
1052,1959,11058,2,12,1947,1742950,16783,0,71270
1053,1950,5282,3,5,1945,1739618,16788,0,71267
1054,1945,4235,0,4,1941,1737328,16792,0,71267
1055,1942,1058,1,1,1941,1738212,16792,0,71267
1056,1942,3092,1,3,1939,1737062,16794,0,71267
1057,1940,2126,1,2,1938,1736876,16795,0,71267
1058,1940,221,2,1,1939,1738595,16796,0,71265
1059,1940,0,1,0,1940,1740535,16795,0,71265
1060,1942,4436,2,5,1937,1738041,16800,0,71263
1061,1937,1067,0,1,1936,1738911,16801,0,71263
1062,1938,7841,2,9,1929,1733008,16810,0,71261
1063,1930,694,1,2,1928,1734244,16812,0,71260
1064,1929,3205,1,3,1926,1732968,16815,0,71259
1065,1926,7064,0,8,1918,1727830,16823,0,71259
1066,1918,6412,0,6,1912,1723336,16829,0,71259
1067,1912,4120,0,5,1907,1721128,16834,0,71259
1068,1907,1347,0,2,1905,1721688,16836,0,71259
1069,1906,6448,1,6,1900,1717146,16841,0,71259
1070,1902,1807,2,2,1900,1717241,16843,0,71257
1071,1900,2147,0,2,1898,1716994,16845,0,71257
1072,1899,7536,1,7,1892,1711357,16852,0,71256
1073,1892,0,0,0,1892,1713249,16852,0,71256
1074,1893,2936,1,3,1890,1712206,16855,0,71255
1075,1891,3236,1,3,1888,1710861,16857,0,71255
1076,1890,3236,2,3,1887,1709515,16859,0,71254
1077,1887,1083,0,1,1886,1710319,16860,0,71254
1078,1886,6488,0,6,1880,1705717,16866,0,71254
1079,1880,1568,0,2,1878,1706029,16868,0,71254
1080,1879,4333,1,4,1875,1703575,16872,0,71253
1081,1876,2172,1,2,1874,1703279,16874,0,71252
1082,1875,3255,1,3,1872,1701899,16877,0,71251
1083,1873,0,1,0,1873,1703772,16876,0,71251
1084,1873,4361,0,4,1869,1701284,16880,0,71251
1085,1869,2571,0,3,1866,1700582,16883,0,71251
1086,1867,1173,1,2,1865,1701276,16885,0,71250
1087,1866,2179,1,2,1864,1700963,16887,0,71249
1088,1864,1093,0,1,1863,1701734,16888,0,71249
1089,1863,1733,0,2,1861,1701864,16890,0,71249
1090,1863,1096,2,1,1862,1702631,16891,0,71247
1091,1862,1315,0,2,1860,1703178,16893,0,71247
1092,1861,3287,1,3,1858,1701752,16896,0,71246
1093,1858,1098,0,1,1857,1702512,16897,0,71246
1094,1857,5001,0,5,1852,1699368,16902,0,71246
1095,1855,0,3,0,1855,1701223,16902,0,71243
1096,1858,1098,3,1,1857,1701983,16903,0,71240
1097,1858,0,1,0,1858,1703841,16903,0,71239
1098,1858,1211,0,2,1856,1704488,16905,0,71239
1099,1856,1316,0,2,1854,1705028,16907,0,71239
1100,1854,0,0,0,1854,1706882,16907,0,71239
