Step,mass_grown,mass_burnt,trees_grown,trees_burnt,trees_count,trees_mass,ashes_count,ashes_mass,empty_count
100,1776,3333,1,32,1744,178899,16464,0,71792
101,1745,3210,1,31,1714,177434,16495,0,71791
102,1715,2254,1,21,1694,176895,16516,0,71790
103,1695,2250,1,21,1674,176340,16537,0,71789
104,1674,2153,0,20,1654,175861,16557,0,71789
105,1655,2604,1,24,1631,174912,16580,0,71789
106,1631,2544,0,24,1607,173999,16604,0,71789
107,1608,3740,1,34,1574,171867,16637,0,71789
108,1575,2843,1,26,1549,170599,16663,0,71788
109,1550,2603,1,23,1527,169546,16686,0,71787
110,1528,2508,1,22,1506,168566,16708,0,71786
111,1507,1954,1,17,1490,168119,16725,0,71785
112,1491,1618,1,14,1477,167992,16739,0,71784
113,1477,1761,0,16,1461,167708,16755,0,71784
114,1462,1782,1,15,1447,167388,16770,0,71783
115,1448,2737,1,23,1425,166099,16793,0,71782
116,1425,2023,0,18,1407,165501,16811,0,71782
117,1409,3380,2,29,1380,163530,16839,0,71781
118,1381,2933,1,24,1357,161978,16863,0,71780
119,1358,1964,1,16,1342,161372,16879,0,71779
120,1343,1237,1,11,1332,161478,16890,0,71778
121,1332,2531,0,21,1311,160279,16911,0,71778
122,1312,2816,1,23,1289,158775,16933,0,71778
123,1290,1849,1,15,1275,158216,16948,0,71777
124,1276,1280,1,10,1266,158212,16958,0,71776
125,1267,2051,1,16,1251,157428,16974,0,71775
126,1251,3589,0,29,1222,155090,17003,0,71775
127,1222,1553,0,12,1210,154759,17015,0,71775
128,1213,2115,3,17,1196,153857,17031,0,71773
129,1197,1590,1,12,1185,153464,17043,0,71772
130,1185,2172,0,16,1169,152477,17059,0,71772
131,1169,1763,0,14,1155,151883,17073,0,71772
132,1157,2033,2,15,1142,151007,17087,0,71771
133,1142,1996,0,15,1127,150153,17102,0,71771
134,1128,2791,1,21,1107,148490,17123,0,71770
135,1107,1656,0,12,1095,147941,17135,0,71770
136,1095,2005,0,15,1080,147031,17150,0,71770
137,1082,1965,2,16,1066,146148,17166,0,71768
138,1069,2545,3,18,1051,144672,17183,0,71766
139,1051,1868,0,13,1038,143855,17196,0,71766
140,1039,2108,1,15,1024,142786,17211,0,71765
141,1024,1883,0,14,1010,141927,17225,0,71765
142,1010,2204,0,15,995,140733,17240,0,71765
143,996,1189,1,9,987,140540,17249,0,71764
144,988,1181,1,8,980,140347,17257,0,71763
145,980,1578,0,11,969,139749,17268,0,71763
146,970,931,1,7,963,139788,17275,0,71762
147,964,952,1,8,956,139800,17283,0,71761
148,957,1353,1,9,948,139404,17292,0,71760
149,948,1671,0,11,937,138681,17303,0,71760
150,937,1854,0,12,925,137764,17315,0,71760
151,927,1385,2,9,918,137306,17324,0,71758
152,918,1406,0,9,909,136818,17333,0,71758
153,910,1252,1,9,901,136476,17342,0,71757
154,901,1454,0,11,890,135923,17353,0,71757
155,891,631,1,4,887,136183,17357,0,71756
156,887,1224,0,8,879,135846,17365,0,71756
157,879,1704,0,11,868,135021,17376,0,71756
158,868,1845,0,12,856,134044,17388,0,71756
159,856,2731,0,17,839,132169,17405,0,71756
160,840,912,1,6,834,132097,17411,0,71755
161,836,1559,2,10,826,131374,17421,0,71753
162,826,1501,0,10,816,130699,17431,0,71753
163,819,2669,3,16,803,128849,17446,0,71751
164,805,2045,2,13,792,127609,17459,0,71749
165,793,1012,1,6,787,127390,17464,0,71749
166,787,2443,0,15,772,125734,17479,0,71749
167,773,1018,1,6,767,125489,17484,0,71749
168,767,514,0,3,764,125742,17487,0,71749
169,765,1555,1,10,755,124952,17496,0,71749
170,757,1908,2,11,746,123801,17507,0,71747
171,746,1295,0,9,737,123252,17516,0,71747
172,737,1257,0,8,729,122732,17524,0,71747
173,730,1293,1,8,722,122169,17532,0,71746
174,723,1613,1,9,714,121279,17541,0,71745
175,717,1902,3,12,705,120094,17553,0,71742
176,705,723,0,4,701,120076,17557,0,71742
177,701,759,0,5,696,120018,17562,0,71742
178,697,378,1,3,694,120337,17564,0,71742
179,694,1792,0,10,684,119239,17574,0,71742
180,685,3163,1,18,667,116761,17592,0,71741
181,667,1298,0,7,660,116130,17599,0,71741
182,660,1313,0,7,653,115477,17606,0,71741
183,655,2015,2,11,644,114117,17615,0,71741
184,645,946,1,5,640,113816,17620,0,71740
185,643,1137,3,7,636,113322,17627,0,71737
186,637,755,1,4,633,113204,17631,0,71736
187,633,1923,0,10,623,111914,17641,0,71736
188,624,197,1,2,622,112341,17643,0,71735
189,622,1652,0,9,613,111311,17652,0,71735
190,614,969,1,5,609,110956,17657,0,71734
191,610,1276,1,8,602,110290,17665,0,71733
192,603,589,1,3,600,110304,17667,0,71733
193,602,786,2,4,598,110120,17671,0,71731
194,598,993,0,5,593,109725,17676,0,71731
195,593,1585,0,8,585,108733,17684,0,71731
196,585,406,0,2,583,108912,17686,0,71731
197,583,799,0,4,579,108696,17690,0,71731
198,580,1145,1,7,573,108131,17697,0,71730
199,573,622,0,4,569,108082,17701,0,71730
200,571,1684,2,10,561,106969,17711,0,71728
201,562,821,1,4,558,106710,17715,0,71727
202,559,1037,1,5,554,106232,17720,0,71726
203,556,1455,2,7,549,105333,17727,0,71724
204,549,638,0,3,546,105244,17730,0,71724
205,546,207,0,1,545,105583,17731,0,71724
206,545,544,0,4,541,105584,17735,0,71724
207,541,1262,0,6,535,104863,17741,0,71724
208,536,1275,1,6,530,104124,17746,0,71724
209,531,1704,1,8,523,102951,17754,0,71723
210,524,1326,1,7,517,102149,17761,0,71722
211,518,648,1,3,515,102019,17764,0,71721
212,516,868,1,4,512,101667,17768,0,71720
213,512,691,0,4,508,101488,17772,0,71720
214,509,799,1,4,505,101198,17776,0,71719
215,506,652,1,3,503,101052,17779,0,71718
216,503,217,0,1,502,101338,17780,0,71718
217,503,1101,1,5,498,100740,17785,0,71717
218,499,219,1,1,498,101020,17785,0,71717
219,498,447,0,3,495,101071,17788,0,71717
220,498,1785,3,8,490,99784,17795,0,71715
221,490,971,0,5,485,99303,17800,0,71715
222,487,1231,2,6,481,98559,17806,0,71713
223,482,712,1,4,478,98329,17810,0,71712
224,478,1660,0,9,469,97147,17819,0,71712
225,469,1142,0,5,464,96474,17824,0,71712
226,466,1764,2,8,458,95176,17831,0,71711
227,458,697,0,3,455,94937,17834,0,71711
228,455,718,0,4,451,94674,17838,0,71711
229,451,702,0,3,448,94423,17841,0,71711
230,448,791,0,4,444,94080,17845,0,71711
231,446,1712,2,9,437,92814,17854,0,71709
232,438,476,1,2,436,92776,17855,0,71709
233,437,954,1,4,433,92259,17859,0,71708
234,435,431,2,3,432,92263,17862,0,71706
235,433,1969,1,9,424,90727,17870,0,71706
236,425,959,1,4,421,90193,17874,0,71705
237,421,479,0,2,419,90135,17876,0,71705
238,419,665,0,4,415,89889,17880,0,71705
239,417,730,2,3,414,89576,17883,0,71703
240,417,1375,3,7,410,88618,17890,0,71700
241,413,0,3,0,413,89031,17890,0,71697
242,413,738,0,3,410,88706,17893,0,71697
243,412,981,2,4,408,88137,17896,0,71696
244,409,1038,1,5,404,87508,17901,0,71695
245,405,938,1,5,400,86975,17905,0,71695
246,401,1005,1,4,397,86371,17909,0,71694
247,398,1667,1,9,389,85102,17918,0,71693
248,390,1025,1,5,385,84467,17923,0,71692
249,385,761,0,3,382,84091,17926,0,71692
250,382,621,0,3,379,83852,17929,0,71692
251,379,1721,0,8,371,82510,17937,0,71692
252,371,792,0,4,367,82089,17941,0,71692
253,368,877,1,6,362,81580,17946,0,71692
254,363,257,1,1,362,81686,17947,0,71691
255,363,267,1,2,361,81782,17948,0,71691
256,362,326,1,2,360,81818,17950,0,71690
257,362,300,2,2,360,81880,17952,0,71688
258,361,1103,1,5,356,81138,17956,0,71688
259,356,360,0,2,354,81134,17958,0,71688
260,356,268,2,2,354,81222,17959,0,71687
261,357,263,3,1,356,81316,17958,0,71686
262,358,506,2,3,355,81168,17961,0,71684
263,355,2192,0,10,345,79331,17971,0,71684
264,347,882,2,5,342,78796,17976,0,71682
265,344,1125,2,6,338,78015,17982,0,71680
266,340,1913,2,7,333,76442,17987,0,71680
267,333,858,0,4,329,75917,17991,0,71680
268,330,1361,1,5,325,74886,17996,0,71679
269,326,560,1,3,323,74652,17999,0,71678
270,323,0,0,0,323,74975,17999,0,71678
271,324,1192,1,6,318,74107,18005,0,71677
272,320,833,2,4,316,73594,18009,0,71675
273,317,1101,1,4,313,72810,18013,0,71674
274,314,833,1,3,311,72291,18015,0,71674
275,313,281,2,1,312,72323,18016,0,71672
276,314,344,2,2,312,72293,18018,0,71670
277,312,843,0,3,309,71762,18021,0,71670
278,310,563,1,2,308,71509,18023,0,71669
279,308,905,0,4,304,70912,18027,0,71669
280,305,583,1,3,302,70634,18029,0,71669
281,304,450,2,4,300,70488,18033,0,71667
282,301,1706,1,6,295,69083,18039,0,71666
283,298,575,3,2,296,68806,18041,0,71663
284,296,286,0,1,295,68816,18042,0,71663
285,296,1159,1,4,292,67953,18046,0,71662
286,294,1184,2,5,289,67063,18051,0,71660
287,289,870,0,3,286,66482,18054,0,71660
288,287,1740,1,6,281,65029,18060,0,71659
289,284,0,3,0,284,65313,18060,0,71656
290,284,898,0,4,280,64699,18064,0,71656
291,282,300,2,1,281,64681,18064,0,71655
292,281,11,0,1,280,64951,18065,0,71655
293,280,296,0,1,279,64935,18066,0,71655
294,280,1207,1,5,275,64008,18071,0,71654
295,276,754,1,3,273,63530,18074,0,71653
296,273,1521,0,6,267,62282,18080,0,71653
297,267,626,0,4,263,61923,18084,0,71653
298,263,914,0,3,260,61272,18087,0,71653
299,260,438,0,2,258,61094,18089,0,71653
300,258,971,0,4,254,60381,18093,0,71653
301,256,453,2,5,251,60184,18098,0,71651
302,252,681,1,4,248,59755,18102,0,71650
303,250,926,2,3,247,59079,18104,0,71649
304,247,1032,0,4,243,58294,18108,0,71649
305,244,636,1,3,241,57902,18111,0,71648
306,241,621,0,3,238,57522,18114,0,71648
307,239,624,1,2,237,57137,18116,0,71647
308,237,312,0,1,236,57062,18117,0,71647
309,237,1247,1,4,233,56052,18121,0,71646
310,235,0,2,0,235,56287,18121,0,71644
311,236,77,1,1,235,56446,18121,0,71644
312,236,724,1,3,233,55958,18124,0,71643
313,234,976,1,4,230,55216,18128,0,71642
314,231,670,1,3,228,54777,18131,0,71641
315,228,0,0,0,228,55005,18131,0,71641
316,230,643,2,3,227,54592,18134,0,71639
317,227,651,0,2,225,54168,18136,0,71639
318,226,429,1,3,223,53965,18139,0,71638
319,224,323,1,1,223,53866,18139,0,71638
320,225,1291,2,4,221,52800,18143,0,71636
321,222,830,1,4,218,52192,18147,0,71635
322,221,358,3,2,219,52055,18148,0,71633
323,219,649,0,2,217,51625,18150,0,71633
324,218,0,1,0,218,51843,18150,0,71632
325,219,334,1,2,217,51728,18152,0,71631
326,219,658,2,2,217,51289,18154,0,71629
327,217,1320,0,4,213,50186,18158,0,71629
328,215,996,2,4,211,49405,18161,0,71628
329,212,131,1,2,210,49486,18163,0,71627
330,210,1003,0,3,207,48693,18166,0,71627
331,207,757,0,4,203,48143,18170,0,71627
332,203,1003,0,4,199,47343,18174,0,71627
333,199,0,0,0,199,47542,18174,0,71627
334,199,335,0,1,198,47406,18175,0,71627
335,199,513,1,3,196,47092,18178,0,71626
336,198,338,2,1,197,46952,18177,0,71626
337,201,0,4,0,201,47153,18176,0,71623
338,201,0,0,0,201,47354,18176,0,71623
339,201,0,0,0,201,47555,18176,0,71623
340,201,387,0,2,199,47369,18178,0,71623
341,201,978,2,5,196,46592,18182,0,71622
342,197,1036,1,3,194,45753,18185,0,71621
343,195,428,1,2,193,45520,18187,0,71620
344,195,962,2,4,191,44753,18191,0,71618
345,191,695,0,2,189,44249,18193,0,71618
346,189,455,0,2,187,43983,18195,0,71618
347,187,375,0,2,185,43795,18197,0,71618
348,187,785,2,3,184,43197,18200,0,71616
349,186,356,2,1,185,43027,18200,0,71615
350,188,1062,3,3,185,42153,18201,0,71614
351,186,24,1,1,185,42315,18201,0,71614
352,186,354,1,1,185,42147,18202,0,71613
353,187,0,2,0,187,42334,18202,0,71611
354,187,357,0,1,186,42164,18203,0,71611
355,186,1438,0,4,182,40912,18207,0,71611
356,182,54,0,1,181,41040,18208,0,71611
357,182,1020,1,3,179,40202,18210,0,71611
358,179,410,0,2,177,39971,18212,0,71611
359,179,0,2,0,179,40150,18212,0,71609
360,183,0,4,0,183,40333,18211,0,71606
361,184,1089,1,3,181,39428,18213,0,71606
362,182,13,1,1,181,39597,18214,0,71605
363,184,105,3,2,182,39676,18215,0,71603
364,185,365,3,1,184,39496,18216,0,71600
365,184,0,0,0,184,39680,18216,0,71600
366,186,1114,2,3,183,38752,18217,0,71600
367,184,0,1,0,184,38936,18216,0,71600
368,186,145,2,2,184,38977,18218,0,71598
369,184,442,0,2,182,38719,18220,0,71598
370,184,432,2,3,181,38471,18222,0,71597
371,182,0,1,0,182,38653,18222,0,71596
372,182,0,0,0,182,38835,18222,0,71596
373,183,0,1,0,183,39018,18222,0,71595
374,183,1130,0,3,180,38071,18225,0,71595
375,180,611,0,4,176,37640,18229,0,71595
376,176,116,0,1,175,37700,18230,0,71595
377,175,56,0,1,174,37819,18231,0,71595
378,174,53,0,2,172,37940,18233,0,71595
379,173,770,1,2,171,37343,18235,0,71594
380,172,0,1,0,172,37515,18234,0,71594
381,172,0,0,0,172,37687,18234,0,71594
382,172,532,0,2,170,37327,18236,0,71594
383,171,393,1,1,170,37105,18237,0,71593
384,170,0,0,0,170,37275,18237,0,71593
385,170,393,0,1,169,37052,18238,0,71593
386,169,391,0,1,168,36830,18239,0,71593
387,169,588,1,3,166,36411,18242,0,71592
388,168,389,2,1,167,36190,18242,0,71591
389,167,10,0,1,166,36347,18243,0,71591
390,166,30,0,1,165,36483,18244,0,71591
391,165,55,0,1,164,36593,18245,0,71591
392,166,691,2,4,162,36068,18248,0,71590
393,162,129,0,1,161,36101,18249,0,71590
394,162,432,1,2,160,35831,18251,0,71589
395,160,0,0,0,160,35991,18251,0,71589
396,162,161,2,1,161,35992,18252,0,71587
397,164,0,3,0,164,36156,18251,0,71585
398,166,341,2,2,164,35981,18253,0,71583
399,165,867,1,4,161,35279,18256,0,71583
400,163,528,2,2,161,34914,18258,0,71581
401,162,51,1,1,161,35025,18259,0,71580
402,162,1062,1,3,159,34125,18261,0,71580
403,160,0,1,0,160,34285,18260,0,71580
404,160,1299,0,6,154,33146,18266,0,71580
405,154,411,0,1,153,32889,18267,0,71580
406,154,410,1,1,153,32633,18268,0,71579
407,153,0,0,0,153,32786,18268,0,71579
408,155,412,2,1,154,32529,18269,0,71577
409,154,1033,0,4,150,31650,18273,0,71577
410,152,0,2,0,152,31802,18273,0,71575
411,153,561,1,2,151,31394,18275,0,71574
412,151,837,0,2,149,30708,18277,0,71574
413,149,0,0,0,149,30857,18277,0,71574
414,149,426,0,1,148,30580,18278,0,71574
415,148,258,0,2,146,30470,18280,0,71574
416,147,493,1,2,145,30124,18281,0,71574
417,147,141,2,2,145,30130,18282,0,71573
418,147,168,2,2,145,30109,18283,0,71572
419,146,325,1,2,144,29930,18285,0,71571
420,144,0,0,0,144,30074,18285,0,71571
421,144,327,0,2,142,29891,18287,0,71571
422,142,159,0,4,138,29874,18291,0,71571
423,138,459,0,2,136,29553,18293,0,71571
424,137,113,1,1,136,29577,18294,0,71570
425,136,106,0,1,135,29607,18295,0,71570
426,135,41,0,2,133,29701,18297,0,71570
427,133,459,0,2,131,29375,18299,0,71570
428,131,937,0,3,128,28569,18302,0,71570
429,129,863,1,2,127,27835,18304,0,71569
430,130,434,3,1,129,27531,18305,0,71566
431,129,777,0,4,125,26883,18309,0,71566
432,127,0,2,0,127,27010,18309,0,71564
433,129,0,2,0,129,27139,18309,0,71562
434,129,435,0,1,128,26833,18310,0,71562
435,128,73,0,1,127,26888,18311,0,71562
436,131,437,4,1,130,26582,18311,0,71559
437,131,443,1,1,130,26270,18311,0,71559
438,131,155,1,2,129,26246,18313,0,71558
439,130,442,1,1,129,25934,18313,0,71558
440,131,0,2,0,131,26065,18313,0,71556
441,132,685,1,2,130,25512,18315,0,71555
442,131,7,1,1,130,25636,18316,0,71554
443,130,1366,0,5,125,24400,18321,0,71554
444,127,891,2,2,125,23636,18323,0,71552
445,128,161,3,1,127,23603,18323,0,71550
446,127,33,0,2,125,23697,18325,0,71550
447,125,452,0,1,124,23370,18326,0,71550
448,125,899,1,2,123,22596,18328,0,71549
449,123,0,0,0,123,22719,18328,0,71549
450,124,198,1,4,120,22645,18332,0,71548
451,121,161,1,2,119,22605,18334,0,71547
452,120,0,1,0,120,22725,18333,0,71547
453,121,99,1,2,119,22747,18334,0,71547
454,120,552,1,2,118,22315,18336,0,71546
455,121,133,3,2,119,22303,18337,0,71544
456,120,530,1,2,118,21893,18339,0,71543
457,118,460,0,1,117,21551,18340,0,71543
458,118,0,1,0,118,21669,18340,0,71542
459,118,20,0,1,117,21767,18341,0,71542
460,117,103,0,2,115,21781,18343,0,71542
461,115,935,0,2,113,20961,18345,0,71542
462,114,0,1,0,114,21075,18345,0,71541
463,114,9,0,1,113,21180,18346,0,71541
464,113,540,0,3,110,20753,18349,0,71541
465,111,0,1,0,111,20864,18349,0,71540
466,111,28,0,1,110,20947,18350,0,71540
467,110,187,0,2,108,20870,18352,0,71540
468,110,0,2,0,110,20980,18352,0,71538
469,112,0,2,0,112,21092,18351,0,71537
470,113,105,1,1,112,21100,18352,0,71536
471,112,489,0,2,110,20723,18354,0,71536
472,112,0,2,0,112,20835,18353,0,71535
473,112,0,0,0,112,20947,18353,0,71535
474,112,633,0,3,109,20426,18356,0,71535
475,110,0,1,0,110,20536,18356,0,71534
476,110,0,0,0,110,20646,18356,0,71534
477,110,882,0,3,107,19874,18359,0,71534
478,108,0,1,0,108,19982,18358,0,71534
479,109,85,1,2,107,20006,18359,0,71534
480,110,0,3,0,110,20116,18358,0,71532
481,110,0,0,0,110,20226,18358,0,71532
482,110,497,0,1,109,19839,18359,0,71532
483,110,597,1,2,108,19352,18361,0,71531
484,109,151,1,2,107,19310,18363,0,71530
485,108,118,1,1,107,19300,18364,0,71529
486,110,0,3,0,110,19410,18364,0,71526
487,111,0,1,0,111,19521,18363,0,71526
488,111,1166,0,4,107,18466,18367,0,71526
489,107,142,0,1,106,18431,18368,0,71526
490,109,0,3,0,109,18540,18367,0,71524
491,110,132,1,1,109,18518,18368,0,71523
492,112,0,3,0,112,18630,18368,0,71520
493,115,178,3,1,114,18567,18368,0,71518
494,115,0,1,0,115,18682,18367,0,71518
495,116,85,1,1,115,18713,18367,0,71518
496,116,0,1,0,116,18829,18366,0,71518
497,116,0,0,0,116,18945,18366,0,71518
498,116,29,0,1,115,19032,18367,0,71518
499,116,583,1,6,110,18565,18373,0,71517
500,112,264,2,2,110,18413,18375,0,71515
501,111,85,1,1,110,18439,18376,0,71514
502,110,503,0,1,109,18046,18377,0,71514
503,109,598,0,2,107,17557,18379,0,71514
504,109,271,2,3,106,17395,18382,0,71512
505,108,0,2,0,108,17503,18380,0,71512
506,108,0,0,0,108,17611,18380,0,71512
507,109,0,1,0,109,17720,18380,0,71511
508,110,1286,1,5,105,16544,18384,0,71511
509,107,20,2,1,106,16631,18384,0,71510
510,107,21,1,1,106,16717,18384,0,71510
511,108,0,2,0,108,16825,18384,0,71508
512,108,204,0,1,107,16729,18385,0,71508
513,108,63,1,1,107,16774,18386,0,71507
514,108,0,1,0,108,16882,18386,0,71506
515,108,718,0,2,106,16272,18388,0,71506
516,106,147,0,2,104,16231,18390,0,71506
517,104,0,0,0,104,16335,18390,0,71506
518,105,0,1,0,105,16440,18390,0,71505
519,106,160,1,2,104,16386,18392,0,71504
520,104,0,0,0,104,16490,18392,0,71504
521,104,530,0,1,103,16064,18393,0,71504
522,105,671,2,2,103,15498,18394,0,71503
523,104,0,1,0,104,15602,18394,0,71502
524,105,529,1,1,104,15178,18395,0,71501
525,105,245,1,1,104,15038,18396,0,71500
526,107,44,3,1,106,15101,18397,0,71497
527,108,0,2,0,108,15209,18396,0,71496
528,109,60,1,1,108,15258,18397,0,71495
529,110,0,2,0,110,15368,18396,0,71494
530,111,0,1,0,111,15479,18396,0,71493
531,112,571,1,2,110,15020,18397,0,71493
532,111,141,1,2,109,14990,18399,0,71492
533,109,101,0,1,108,14998,18400,0,71492
534,108,135,0,1,107,14971,18401,0,71492
535,108,84,1,1,107,14995,18402,0,71491
536,108,37,1,1,107,15066,18403,0,71490
537,108,519,1,4,104,14655,18407,0,71489
538,104,59,0,1,103,14700,18408,0,71489
539,104,0,1,0,104,14804,18407,0,71489
540,104,0,0,0,104,14908,18407,0,71489
541,104,0,0,0,104,15012,18407,0,71489
542,105,0,1,0,105,15117,18407,0,71488
543,106,545,1,1,105,14678,18407,0,71488
544,105,0,0,0,105,14783,18407,0,71488
545,106,0,1,0,106,14889,18407,0,71487
546,107,602,1,2,105,14394,18409,0,71486
547,105,0,0,0,105,14499,18409,0,71486
548,106,0,1,0,106,14605,18409,0,71485
549,108,551,2,1,107,14162,18410,0,71483
550,108,0,1,0,108,14270,18410,0,71482
551,108,0,0,0,108,14378,18410,0,71482
552,109,161,1,1,108,14326,18411,0,71481
553,109,128,1,3,106,14307,18414,0,71480
554,107,0,1,0,107,14414,18413,0,71480
555,107,165,0,2,105,14356,18415,0,71480
556,108,409,3,2,106,14055,18416,0,71478
557,107,104,1,2,105,14058,18418,0,71477
558,106,353,1,4,102,13811,18422,0,71476
559,103,50,1,1,102,13864,18423,0,71475
560,102,563,0,1,101,13403,18424,0,71475
561,101,165,0,2,99,13339,18426,0,71475
562,99,168,0,2,97,13270,18428,0,71475
563,98,8,1,1,97,13360,18428,0,71475
564,98,417,1,3,95,13041,18431,0,71474
565,96,110,1,1,95,13027,18432,0,71473
566,97,0,2,0,97,13124,18432,0,71471
567,97,0,0,0,97,13221,18432,0,71471
568,99,360,2,1,98,12960,18433,0,71469
569,98,251,0,1,97,12807,18434,0,71469
570,100,578,3,1,99,12329,18435,0,71466
571,100,123,1,2,98,12306,18437,0,71465
572,100,87,2,2,98,12319,18439,0,71463
573,100,0,2,0,100,12419,18438,0,71462
574,102,53,2,1,101,12468,18438,0,71461
575,104,0,3,0,104,12572,18438,0,71458
576,104,196,0,3,101,12480,18441,0,71458
577,101,0,0,0,101,12581,18441,0,71458
578,102,0,1,0,102,12683,18441,0,71457
579,102,37,0,1,101,12748,18442,0,71457
580,103,0,2,0,103,12851,18442,0,71455
581,103,271,0,2,101,12683,18444,0,71455
582,103,0,2,0,103,12786,18444,0,71453
583,103,597,0,3,100,12292,18447,0,71453
584,101,130,1,2,99,12263,18449,0,71452
585,99,156,0,1,98,12206,18450,0,71452
586,98,146,0,1,97,12158,18451,0,71452
587,98,46,1,1,97,12210,18452,0,71451
588,99,0,2,0,99,12309,18451,0,71450
589,100,253,1,2,98,12156,18453,0,71449
590,98,396,0,2,96,11858,18455,0,71449
591,96,0,0,0,96,11954,18455,0,71449
592,97,191,1,3,94,11860,18458,0,71448
593,95,0,1,0,95,11955,18458,0,71447
594,96,332,1,2,94,11719,18460,0,71446
595,95,241,1,2,93,11573,18462,0,71445
596,94,0,1,0,94,11667,18462,0,71444
597,96,0,2,0,96,11763,18462,0,71442
598,99,203,3,2,97,11659,18464,0,71439
599,99,387,2,6,93,11371,18468,0,71439
600,95,169,2,1,94,11297,18468,0,71438
601,95,76,1,1,94,11316,18469,0,71437
602,94,75,0,1,93,11335,18470,0,71437
603,93,0,0,0,93,11428,18470,0,71437
604,94,248,1,2,92,11274,18472,0,71436
605,92,0,0,0,92,11366,18472,0,71436
606,92,237,0,1,91,11221,18473,0,71436
607,91,79,0,1,90,11233,18474,0,71436
608,90,85,0,1,89,11238,18475,0,71436
609,90,47,1,1,89,11281,18476,0,71435
610,89,0,0,0,89,11370,18476,0,71435
611,89,15,0,1,88,11444,18477,0,71435
612,90,116,2,2,88,11418,18479,0,71433
613,88,0,0,0,88,11506,18479,0,71433
614,89,0,1,0,89,11595,18479,0,71432
615,89,0,0,0,89,11684,18479,0,71432
616,90,0,1,0,90,11774,18479,0,71431
617,90,0,0,0,90,11864,18479,0,71431
618,94,0,4,0,94,11958,18478,0,71428
619,94,338,0,3,91,11714,18481,0,71428
620,91,0,0,0,91,11805,18481,0,71428
621,92,97,1,2,90,11800,18482,0,71428
622,90,108,0,2,88,11782,18484,0,71428
623,88,0,0,0,88,11870,18484,0,71428
624,90,0,2,0,90,11960,18484,0,71426
625,90,186,0,1,89,11864,18485,0,71426
626,89,0,0,0,89,11953,18485,0,71426
627,91,91,2,2,89,11953,18486,0,71425
628,91,122,2,1,90,11922,18485,0,71425
629,91,0,1,0,91,12013,18485,0,71424
630,91,636,0,1,90,11468,18486,0,71424
631,91,123,1,2,89,11436,18488,0,71423
632,90,153,1,1,89,11373,18489,0,71422
633,89,122,0,2,87,11340,18491,0,71422
634,87,0,0,0,87,11427,18491,0,71422
635,87,5,0,1,86,11509,18492,0,71422
636,87,321,1,1,86,11275,18493,0,71421
637,87,93,1,1,86,11269,18494,0,71420
638,87,100,1,1,86,11256,18495,0,71419
639,87,91,1,1,86,11252,18496,0,71418
640,87,90,1,2,85,11249,18498,0,71417
641,86,0,1,0,86,11335,18498,0,71416
642,86,45,0,1,85,11376,18499,0,71416
643,87,0,2,0,87,11463,18499,0,71414
644,87,146,0,2,85,11404,18501,0,71414
645,86,0,1,0,86,11490,18501,0,71413
646,87,29,1,1,86,11548,18502,0,71412
647,87,0,1,0,87,11635,18502,0,71411
648,87,169,0,2,85,11553,18504,0,71411
649,85,101,0,1,84,11537,18505,0,71411
650,85,147,1,1,84,11475,18506,0,71410
651,84,0,0,0,84,11559,18506,0,71410
652,85,10,1,1,84,11634,18507,0,71409
653,87,0,3,0,87,11721,18507,0,71406
654,88,0,1,0,88,11809,18507,0,71405
655,88,2,0,1,87,11895,18508,0,71405
656,89,354,2,2,87,11630,18510,0,71403
657,90,222,3,1,89,11498,18511,0,71400
658,90,6,1,1,89,11582,18512,0,71399
659,90,0,1,0,90,11672,18512,0,71398
660,90,22,0,1,89,11740,18513,0,71398
661,92,16,3,1,91,11816,18514,0,71395
662,93,0,2,0,93,11909,18514,0,71393
663,96,320,3,1,95,11685,18515,0,71390
664,95,7,0,1,94,11773,18516,0,71390
665,97,0,3,0,97,11870,18514,0,71389
666,97,42,0,2,95,11925,18516,0,71389
667,97,75,2,1,96,11947,18516,0,71388
668,99,95,3,1,98,11951,18517,0,71385
669,98,0,0,0,98,12049,18517,0,71385
670,98,0,0,0,98,12147,18517,0,71385
671,98,99,0,1,97,12146,18518,0,71385
672,101,954,4,3,98,11293,18520,0,71382
673,101,0,3,0,101,11394,18519,0,71380
674,103,23,2,1,102,11474,18520,0,71378
675,102,58,0,1,101,11518,18521,0,71378
676,101,0,0,0,101,11619,18521,0,71378
677,102,0,1,0,102,11721,18521,0,71377
678,102,99,0,1,101,11724,18522,0,71377
679,101,0,0,0,101,11825,18522,0,71377
680,101,4,0,1,100,11922,18523,0,71377
681,101,214,1,1,100,11809,18524,0,71376
682,101,0,1,0,101,11910,18524,0,71375
683,101,56,0,1,100,11955,18525,0,71375
684,103,298,3,2,101,11760,18527,0,71372
685,102,275,1,2,100,11587,18529,0,71371
686,102,0,2,0,102,11689,18529,0,71369
687,103,0,1,0,103,11792,18529,0,71368
688,103,0,0,0,103,11895,18529,0,71368
689,105,0,2,0,105,12000,18528,0,71367
690,105,101,0,2,103,12004,18530,0,71367
691,104,0,1,0,104,12108,18530,0,71366
692,106,262,2,3,103,11952,18533,0,71364
693,106,41,3,1,105,12017,18534,0,71361
694,106,212,1,3,103,11911,18537,0,71360
695,104,0,1,0,104,12015,18537,0,71359
696,104,0,0,0,104,12119,18537,0,71359
697,104,51,0,1,103,12172,18538,0,71359
698,105,0,2,0,105,12277,18538,0,71357
699,106,73,1,1,105,12310,18539,0,71356
700,105,0,0,0,105,12415,18539,0,71356
701,107,18,2,1,106,12504,18539,0,71355
702,108,11,2,1,107,12601,18540,0,71353
703,107,10,0,1,106,12698,18541,0,71353
704,107,194,1,2,105,12611,18543,0,71352
705,107,0,2,0,107,12718,18543,0,71350
706,109,0,2,0,109,12827,18543,0,71348
707,109,6,0,1,108,12930,18544,0,71348
708,109,356,1,3,106,12683,18547,0,71347
709,107,0,1,0,107,12790,18546,0,71347
710,107,59,0,3,104,12838,18549,0,71347
711,104,0,0,0,104,12942,18549,0,71347
712,106,0,2,0,106,13048,18549,0,71345
713,107,826,1,3,104,12329,18552,0,71344
714,105,0,1,0,105,12434,18551,0,71344
715,105,194,0,1,104,12345,18552,0,71344
716,106,0,2,0,106,12451,18550,0,71344
717,106,0,0,0,106,12557,18550,0,71344
718,107,31,1,2,105,12633,18552,0,71343
719,105,184,0,2,103,12554,18554,0,71343
720,103,443,0,2,101,12214,18556,0,71343
721,101,750,0,2,99,11565,18558,0,71343
722,100,0,1,0,100,11665,18558,0,71342
723,100,0,0,0,100,11765,18558,0,71342
724,103,0,3,0,103,11868,18558,0,71339
725,105,17,2,1,104,11956,18559,0,71337
726,104,0,0,0,104,12060,18559,0,71337
727,104,127,0,1,103,12037,18560,0,71337
728,103,0,0,0,103,12140,18560,0,71337
729,105,0,2,0,105,12245,18560,0,71335
730,106,7,1,1,105,12344,18561,0,71334
731,106,0,1,0,106,12450,18561,0,71333
732,107,91,1,3,104,12466,18564,0,71332
733,104,277,0,2,102,12293,18566,0,71332
734,102,741,0,1,101,11654,18567,0,71332
735,102,466,1,4,98,11290,18571,0,71331
736,100,140,2,2,98,11250,18572,0,71330
737,99,0,1,0,99,11349,18572,0,71329
738,101,77,2,1,100,11373,18573,0,71327
739,101,0,1,0,101,11474,18573,0,71326
740,101,117,0,1,100,11458,18574,0,71326
741,101,433,1,2,99,11126,18576,0,71325
742,100,71,1,1,99,11155,18576,0,71325
743,101,0,2,0,101,11256,18576,0,71323
744,103,0,2,0,103,11359,18576,0,71321
745,105,0,2,0,105,11464,18576,0,71319
746,105,93,0,2,103,11476,18578,0,71319
747,106,91,3,1,105,11491,18579,0,71316
748,106,273,1,3,103,11324,18582,0,71315
749,103,15,0,1,102,11412,18583,0,71315
750,102,78,0,1,101,11436,18584,0,71315
751,101,0,0,0,101,11537,18584,0,71315
752,101,248,0,2,99,11390,18586,0,71315
753,101,0,2,0,101,11491,18586,0,71313
754,101,151,0,2,99,11441,18588,0,71313
755,100,100,1,1,99,11441,18589,0,71312
756,99,385,0,3,96,11155,18592,0,71312
757,96,0,0,0,96,11251,18592,0,71312
758,98,0,2,0,98,11349,18592,0,71310
759,100,88,2,1,99,11361,18593,0,71308
760,100,1007,1,3,97,10454,18595,0,71308
761,98,15,1,1,97,10537,18596,0,71307
762,98,0,1,0,98,10635,18596,0,71306
763,98,0,0,0,98,10733,18596,0,71306
764,99,0,1,0,99,10832,18596,0,71305
765,100,145,1,1,99,10787,18597,0,71304
766,99,390,0,4,95,10496,18601,0,71304
767,95,187,0,2,93,10404,18603,0,71304
768,94,77,1,1,93,10421,18604,0,71303
769,94,0,1,0,94,10515,18603,0,71303
770,96,321,2,2,94,10290,18605,0,71301
771,94,0,0,0,94,10384,18605,0,71301
772,94,0,0,0,94,10478,18605,0,71301
773,97,175,3,1,96,10400,18605,0,71299
774,97,50,1,1,96,10447,18606,0,71298
775,97,3,1,1,96,10541,18607,0,71297
776,96,620,0,3,93,10017,18610,0,71297
777,93,70,0,1,92,10040,18611,0,71297
778,94,0,2,0,94,10134,18610,0,71296
779,96,42,2,1,95,10188,18611,0,71294
780,98,0,3,0,98,10286,18611,0,71291
781,99,0,1,0,99,10385,18611,0,71290
782,101,0,2,0,101,10486,18611,0,71288
783,101,244,0,2,99,10343,18613,0,71288
784,99,0,0,0,99,10442,18613,0,71288
785,99,0,0,0,99,10541,18613,0,71288
786,100,0,1,0,100,10641,18613,0,71287
787,101,316,1,1,100,10426,18613,0,71287
788,101,106,1,2,99,10421,18615,0,71286
789,99,106,0,1,98,10414,18616,0,71286
790,98,827,0,2,96,9685,18618,0,71286
791,96,154,0,1,95,9627,18619,0,71286
792,96,0,1,0,96,9723,18618,0,71286
793,97,795,1,1,96,9025,18619,0,71285
794,96,222,0,2,94,8899,18621,0,71285
795,95,0,1,0,95,8994,18620,0,71285
796,96,81,1,1,95,9009,18620,0,71285
797,96,0,1,0,96,9105,18620,0,71284
798,98,0,2,0,98,9203,18620,0,71282
799,98,96,0,1,97,9205,18621,0,71282
800,97,130,0,2,95,9172,18623,0,71282
801,95,0,0,0,95,9267,18623,0,71282
802,96,0,1,0,96,9363,18622,0,71282
803,98,75,2,1,97,9386,18622,0,71281
804,99,27,2,1,98,9458,18623,0,71279
805,100,0,2,0,100,9558,18622,0,71278
806,100,271,0,3,97,9387,18625,0,71278
807,98,0,1,0,98,9485,18625,0,71277
808,98,125,0,1,97,9458,18626,0,71277
809,98,50,1,1,97,9506,18627,0,71276
810,97,93,0,2,95,9510,18629,0,71276
811,97,38,2,1,96,9569,18630,0,71274
812,98,0,2,0,98,9667,18630,0,71272
813,98,9,0,1,97,9756,18631,0,71272
814,97,0,0,0,97,9853,18631,0,71272
815,97,138,0,3,94,9812,18634,0,71272
816,94,22,0,1,93,9884,18635,0,71272
817,93,305,0,2,91,9672,18637,0,71272
818,93,290,2,2,91,9475,18638,0,71271
819,93,2,2,1,92,9566,18637,0,71271
820,92,0,0,0,92,9658,18637,0,71271
821,93,75,1,1,92,9676,18638,0,71270
822,92,25,0,1,91,9743,18639,0,71270
823,92,0,1,0,92,9835,18639,0,71269
824,93,0,1,0,93,9928,18639,0,71268
825,93,73,0,1,92,9948,18640,0,71268
826,93,59,1,1,92,9982,18641,0,71267
827,92,130,0,2,90,9944,18643,0,71267
828,90,37,0,1,89,9997,18644,0,71267
829,89,336,0,2,87,9750,18646,0,71267
830,87,150,0,1,86,9687,18647,0,71267
831,86,125,0,2,84,9648,18649,0,71267
832,85,0,1,0,85,9733,18649,0,71266
833,86,0,1,0,86,9819,18648,0,71266
834,87,0,1,0,87,9906,18648,0,71265
835,87,0,0,0,87,9993,18648,0,71265
836,87,292,0,3,84,9788,18651,0,71265
837,85,126,1,1,84,9747,18652,0,71264
838,88,150,4,2,86,9685,18652,0,71262
839,86,0,0,0,86,9771,18652,0,71262
840,87,173,1,1,86,9685,18653,0,71261
841,87,197,1,1,86,9575,18654,0,71260
842,87,573,1,3,84,9089,18657,0,71259
843,85,13,1,2,83,9161,18659,0,71258
844,83,64,0,1,82,9180,18660,0,71258
845,83,37,1,1,82,9226,18660,0,71258
846,83,0,1,0,83,9309,18660,0,71257
847,85,0,2,0,85,9394,18660,0,71255
848,86,0,1,0,86,9480,18659,0,71255
849,86,4,0,1,85,9562,18660,0,71255
850,86,0,1,0,86,9648,18660,0,71254
851,86,65,0,2,84,9669,18662,0,71254
852,84,0,0,0,84,9753,18662,0,71254
853,85,465,1,2,83,9373,18664,0,71253
854,84,0,1,0,84,9457,18664,0,71252
855,85,242,1,1,84,9300,18665,0,71251
856,85,0,1,0,85,9385,18664,0,71251
857,86,88,1,1,85,9383,18664,0,71251
858,85,0,0,0,85,9468,18664,0,71251
859,85,102,0,1,84,9451,18665,0,71251
860,84,370,0,1,83,9165,18666,0,71251
861,84,0,1,0,84,9249,18666,0,71250
862,84,178,0,1,83,9155,18667,0,71250
863,85,16,2,1,84,9224,18668,0,71248
864,84,0,0,0,84,9308,18668,0,71248
865,85,14,1,2,83,9379,18669,0,71248
866,84,0,1,0,84,9463,18669,0,71247
867,84,0,0,0,84,9547,18669,0,71247
868,87,1,3,1,86,9633,18670,0,71244
869,87,0,1,0,87,9720,18670,0,71243
870,87,102,0,1,86,9705,18671,0,71243
871,87,192,1,2,85,9600,18673,0,71242
872,85,350,0,2,83,9335,18675,0,71242
873,85,71,2,1,84,9349,18675,0,71241
874,85,366,1,2,83,9068,18677,0,71240
875,83,0,0,0,83,9151,18677,0,71240
876,83,139,0,1,82,9095,18678,0,71240
877,82,0,0,0,82,9177,18678,0,71240
878,82,279,0,1,81,8980,18679,0,71240
879,81,0,0,0,81,9061,18679,0,71240
880,82,322,1,1,81,8821,18680,0,71239
881,81,70,0,1,80,8832,18681,0,71239
882,83,0,3,0,83,8915,18680,0,71237
883,85,0,2,0,85,9000,18679,0,71236
884,86,105,1,1,85,8981,18680,0,71235
885,85,52,0,2,83,9014,18682,0,71235
886,84,174,1,2,82,8924,18684,0,71234
887,82,0,0,0,82,9006,18684,0,71234
888,83,28,1,1,82,9061,18684,0,71234
889,82,0,0,0,82,9143,18684,0,71234
890,82,0,0,0,82,9225,18684,0,71234
891,84,0,2,0,84,9309,18683,0,71233
892,86,0,2,0,86,9395,18683,0,71231
893,87,222,1,2,85,9260,18685,0,71230
894,87,126,2,3,84,9221,18688,0,71228
895,85,0,1,0,85,9306,18688,0,71227
896,88,0,3,0,88,9394,18687,0,71225
897,89,0,1,0,89,9483,18687,0,71224
898,89,0,0,0,89,9572,18687,0,71224
899,90,17,1,1,89,9645,18688,0,71223
900,89,0,0,0,89,9734,18688,0,71223
901,90,353,1,2,88,9471,18690,0,71222
902,88,7,0,1,87,9552,18691,0,71222
903,87,0,0,0,87,9639,18691,0,71222
904,87,21,0,1,86,9705,18692,0,71222
905,86,127,0,1,85,9664,18693,0,71222
906,85,0,0,0,85,9749,18693,0,71222
907,86,9,1,1,85,9826,18694,0,71221
908,87,164,2,1,86,9749,18695,0,71219
909,86,165,0,1,85,9670,18696,0,71219
910,86,111,1,2,84,9645,18698,0,71218
911,84,0,0,0,84,9729,18698,0,71218
912,85,0,1,0,85,9814,18697,0,71218
913,87,128,2,1,86,9773,18697,0,71217
914,88,272,2,3,85,9589,18700,0,71215
915,85,0,0,0,85,9674,18700,0,71215
916,86,278,1,2,84,9482,18702,0,71214
917,84,114,0,1,83,9452,18703,0,71214
918,87,254,4,3,84,9285,18705,0,71211
919,85,13,1,1,84,9357,18706,0,71210
920,85,162,1,1,84,9280,18707,0,71209
921,87,134,3,1,86,9233,18708,0,71206
922,86,173,0,2,84,9146,18710,0,71206
923,84,0,0,0,84,9230,18710,0,71206
924,84,31,0,1,83,9283,18711,0,71206
925,85,0,2,0,85,9368,18711,0,71204
926,87,62,2,1,86,9393,18712,0,71202
927,87,387,1,3,84,9093,18715,0,71201
928,85,89,1,1,84,9089,18716,0,71200
929,86,0,2,0,86,9175,18716,0,71198
930,86,0,0,0,86,9261,18716,0,71198
931,87,0,1,0,87,9348,18715,0,71198
932,87,288,0,2,85,9147,18717,0,71198
933,86,81,1,1,85,9152,18718,0,71197
934,86,81,1,1,85,9157,18718,0,71197
935,86,320,1,2,84,8923,18720,0,71196
936,84,435,0,3,81,8572,18723,0,71196
937,81,0,0,0,81,8653,18723,0,71196
938,83,0,2,0,83,8736,18723,0,71194
939,84,390,1,2,82,8430,18724,0,71194
940,82,0,0,0,82,8512,18724,0,71194
941,83,622,1,2,81,7973,18725,0,71194
942,82,0,1,0,82,8055,18724,0,71194
943,83,0,1,0,83,8138,18723,0,71194
944,83,0,0,0,83,8221,18723,0,71194
945,85,171,2,1,84,8135,18724,0,71192
946,86,0,2,0,86,8221,18724,0,71190
947,87,196,1,2,85,8112,18726,0,71189
948,89,1,4,1,88,8200,18724,0,71188
949,91,62,3,1,90,8229,18724,0,71186
950,90,0,0,0,90,8319,18724,0,71186
951,95,0,5,0,95,8414,18723,0,71182
952,97,5,2,1,96,8506,18724,0,71180
953,97,3,1,1,96,8600,18725,0,71179
954,97,0,1,0,97,8697,18725,0,71178
955,98,27,1,1,97,8768,18726,0,71177
956,97,32,0,1,96,8833,18727,0,71177
957,97,12,1,1,96,8918,18728,0,71176
958,96,121,0,1,95,8893,18729,0,71176
959,95,87,0,1,94,8901,18730,0,71176
960,94,79,0,1,93,8916,18731,0,71176
961,93,52,0,1,92,8957,18732,0,71176
962,92,69,0,1,91,8980,18733,0,71176
963,92,53,1,2,90,9019,18735,0,71175
964,90,0,0,0,90,9109,18735,0,71175
965,91,47,1,3,88,9153,18738,0,71174
966,88,134,0,1,87,9107,18739,0,71174
967,87,27,0,1,86,9167,18740,0,71174
968,87,0,1,0,87,9254,18739,0,71174
969,87,0,0,0,87,9341,18739,0,71174
970,88,102,1,1,87,9327,18740,0,71173
971,88,0,1,0,88,9415,18740,0,71172
972,88,177,0,1,87,9326,18741,0,71172
973,88,107,1,2,86,9307,18743,0,71171
974,88,0,2,0,88,9395,18743,0,71169
975,89,0,1,0,89,9484,18743,0,71168
976,90,0,1,0,90,9574,18743,0,71167
977,90,0,0,0,90,9664,18743,0,71167
978,90,370,0,2,88,9384,18745,0,71167
979,89,183,1,2,87,9290,18747,0,71166
980,87,690,0,2,85,8687,18749,0,71166
981,85,212,0,2,83,8560,18751,0,71166
982,83,0,0,0,83,8643,18751,0,71166
983,83,71,0,1,82,8655,18752,0,71166
984,83,313,1,1,82,8425,18753,0,71165
985,82,67,0,1,81,8440,18754,0,71165
986,82,277,1,2,80,8245,18756,0,71164
987,81,74,1,2,79,8252,18758,0,71163
988,81,0,2,0,81,8333,18758,0,71161
989,81,0,0,0,81,8414,18758,0,71161
990,83,223,2,2,81,8274,18760,0,71159
991,81,74,0,1,80,8281,18761,0,71159
992,80,0,0,0,80,8361,18761,0,71159
993,81,0,1,0,81,8442,18761,0,71158
994,83,53,2,1,82,8472,18761,0,71157
995,83,28,1,1,82,8527,18761,0,71157
996,82,141,0,1,81,8468,18762,0,71157
997,81,77,0,1,80,8472,18763,0,71157
998,80,0,0,0,80,8552,18763,0,71157
999,81,61,1,1,80,8572,18764,0,71156
1000,80,0,0,0,80,8652,18764,0,71156
1001,80,0,0,0,80,8732,18764,0,71156
1002,82,117,2,1,81,8697,18764,0,71155
1003,82,0,1,0,82,8779,18764,0,71154
1004,82,19,0,1,81,8842,18765,0,71154
1005,83,0,2,0,83,8925,18765,0,71152
1006,85,0,2,0,85,9010,18765,0,71150
1007,86,0,1,0,86,9096,18765,0,71149
1008,86,62,0,1,85,9120,18766,0,71149
1009,85,293,0,3,82,8912,18769,0,71149
1010,83,0,1,0,83,8995,18769,0,71148
1011,83,0,0,0,83,9078,18769,0,71148
1012,86,254,3,1,85,8910,18769,0,71146
1013,85,119,0,2,83,8876,18771,0,71146
1014,84,145,1,2,82,8815,18773,0,71145
1015,82,0,0,0,82,8897,18773,0,71145
1016,85,376,3,1,84,8606,18773,0,71143
1017,85,53,1,1,84,8638,18774,0,71142
1018,85,0,1,0,85,8723,18774,0,71141
1019,85,23,0,2,83,8785,18776,0,71141
1020,86,0,3,0,86,8871,18775,0,71139
1021,86,32,0,1,85,8925,18776,0,71139
1022,86,141,1,1,85,8870,18776,0,71139
1023,86,95,1,1,85,8861,18777,0,71138
1024,85,259,0,3,82,8687,18780,0,71138
1025,82,10,0,1,81,8759,18781,0,71138
1026,82,0,1,0,82,8841,18781,0,71137
1027,83,0,1,0,83,8924,18780,0,71137
1028,86,0,3,0,86,9010,18780,0,71134
1029,87,237,1,2,85,8860,18782,0,71133
1030,88,0,3,0,88,8948,18782,0,71130
1031,89,0,1,0,89,9037,18782,0,71129
1032,92,0,3,0,92,9129,18781,0,71127
1033,93,0,1,0,93,9222,18781,0,71126
1034,93,138,0,2,91,9177,18783,0,71126
1035,91,0,0,0,91,9268,18783,0,71126
1036,92,0,1,0,92,9360,18783,0,71125
1037,94,11,2,1,93,9443,18784,0,71123
1038,93,140,0,3,90,9396,18787,0,71123
1039,90,46,0,1,89,9440,18788,0,71123
1040,90,217,1,2,88,9313,18790,0,71122
1041,89,0,1,0,89,9402,18790,0,71121
1042,89,33,0,2,87,9458,18792,0,71121
1043,89,18,2,1,88,9529,18793,0,71119
1044,89,0,1,0,89,9618,18793,0,71118
1045,89,105,0,3,86,9602,18796,0,71118
1046,88,0,2,0,88,9690,18796,0,71116
1047,91,16,3,1,90,9765,18797,0,71113
1048,91,326,1,2,89,9530,18799,0,71112
1049,91,18,2,1,90,9603,18800,0,71110
1050,90,0,0,0,90,9693,18800,0,71110
1051,90,0,0,0,90,9783,18800,0,71110
1052,91,271,1,1,90,9603,18801,0,71109
1053,90,832,0,3,87,8861,18804,0,71109
1054,88,0,1,0,88,8949,18804,0,71108
1055,89,25,1,1,88,9013,18805,0,71107
1056,89,0,1,0,89,9102,18805,0,71106
1057,89,0,0,0,89,9191,18805,0,71106
1058,90,446,1,4,86,8835,18808,0,71106
1059,88,280,2,1,87,8643,18808,0,71105
1060,89,0,2,0,89,8732,18808,0,71103
1061,89,264,0,1,88,8557,18809,0,71103
1062,88,258,0,1,87,8387,18810,0,71103
1063,87,133,0,2,85,8341,18812,0,71103
1064,85,0,0,0,85,8426,18812,0,71103
1065,86,0,1,0,86,8512,18811,0,71103
1066,87,93,1,1,86,8506,18812,0,71102
1067,87,0,1,0,87,8593,18812,0,71101
1068,87,13,0,1,86,8667,18813,0,71101
1069,86,0,0,0,86,8753,18813,0,71101
1070,87,619,1,4,83,8221,18816,0,71101
1071,83,0,0,0,83,8304,18816,0,71101
1072,83,33,0,1,82,8354,18817,0,71101
1073,84,404,2,3,81,8034,18820,0,71099
1074,83,16,2,1,82,8101,18821,0,71097
1075,82,0,0,0,82,8183,18821,0,71097
1076,83,214,1,1,82,8052,18822,0,71096
1077,83,0,1,0,83,8135,18821,0,71096
1078,84,135,1,2,82,8084,18823,0,71095
1079,82,47,0,1,81,8119,18824,0,71095
1080,85,271,4,3,82,7933,18825,0,71093
1081,86,0,4,0,86,8019,18824,0,71090
1082,87,508,1,1,86,7598,18825,0,71089
1083,89,53,3,2,87,7634,18827,0,71086
1084,89,0,2,0,89,7723,18827,0,71084
1085,89,49,0,1,88,7763,18828,0,71084
1086,89,179,1,1,88,7673,18829,0,71083
1087,90,100,2,1,89,7663,18830,0,71081
1088,91,0,2,0,91,7754,18830,0,71079
1089,91,0,0,0,91,7845,18830,0,71079
1090,93,199,2,2,91,7739,18832,0,71077
1091,91,0,0,0,91,7830,18832,0,71077
1092,91,0,0,0,91,7921,18832,0,71077
1093,92,82,1,1,91,7931,18832,0,71077
1094,93,14,2,1,92,8010,18833,0,71075
1095,94,228,2,1,93,7876,18834,0,71073
1096,93,252,0,1,92,7717,18835,0,71073
1097,93,80,1,1,92,7730,18836,0,71072
1098,92,0,0,0,92,7822,18836,0,71072
1099,93,419,1,2,91,7496,18838,0,71071
1100,93,181,2,1,92,7408,18838,0,71070
